registry -> a place where a register is kept

register -> a book in which records of acts, events, names, etc., are kept

dominant -> ruling, governing, or controlling; having or exerting authority or influence

put forth -> to present; propose

propose -> to offer or suggest

exert -> make a physical or mental effort.

vigor -> active strength or force.

vigorous -> full of or characterized by vigor.

migrate -> to go from one country, region, or place to another.

analogy -> a similarity between like features of two things, on which a comparison may be based

correspond -> to be in agreement or conformity / to be similar or analogous; be equivalent in function, position, amount, etc.

utility -> the state or quality of being useful; usefulness

benchmark -> a standard of excellence, achievement, etc., against which similar things must be measured or judged

scrap -> a small piece or amount of something, especially one that is left over after the greater part has been used.

scratch -> to break, mar, or mark the surface of by rubbing, scraping, or tearing with something sharp or rough

opaque -> not transparent or translucent

opacity -> the state or quality of being opaque

modularity -> the use of individually distinct functional units, as in assembling an electronic or mechanical system

audit -> an official examination and verification of accounts and records, especially of financial accounts

bind -> to fasten or secure with a band or bond / tie or fasten (something) tightly together.

establish -> to found, institute, build, or bring into being on a firm or stable basis

habitually -> as a habit, or an established way of being or acting; routinely or regularly

veneration -> great respect; reverence.

sacred -> connected with God (or the gods) or dedicated to a religious purpose and so deserving veneration.

profane -> relating or devoted to that which is not sacred or biblical; secular rather than religious.

pertain -> to have reference or relation; relate

constitute -> to compose; form.

peculiar -> strange or odd; unusual.

quirk -> a peculiar behavioral habit.

characteristic -> pertaining to, constituting, or indicating the character or peculiar quality of a person or thing; typical; distinctive.

permissive -> habitually or characteristically accepting or tolerant of something, as social behavior or linguistic usage, that others might disapprove or forbid.

ample -> fully sufficient or more than adequate for the purpose or needs; plentiful; enough

substantial -> of ample or considerable amount, quantity, size, etc.

portion -> a part of any whole, either separated from or integrated with it

rouse -> to bring out of a state of sleep, unconsciousness, inactivity, fancied security, apathy, depression, etc.

stimulate -> to rouse to action or effort, as by encouragement or pressure; spur on; incite. / raise levels of physiological or nervous activity in (the body or any biological system).

provoke -> stimulate or give rise to (a reaction or emotion, typically a strong or unwelcome one) in someone.

appetizer -> a small portion of a food or drink served before or at the beginning of a meal to stimulate the desire to eat.

abolish -> formally put an end to (a system, practice, or institution).

suppress -> to do away with by or as by authority; abolish; stop (a practice, custom, etc.). / forcibly put an end to.

apathy -> absence or suppression of passion, emotion, or excitement / lack of interest in or concern for things that others find moving or exciting

endeavor -> to attempt; try / to exert oneself to do or effect something; make an effort; strive.

imitate -> to follow or endeavor to follow as a model or example. / his style was imitated by many other writers

earnest -> serious in intention, purpose, or effort.

deity -> a god or goddess (in a polytheistic religion).

goddess -> a female deity.

supplication -> the action of asking or begging for something earnestly or humbly.

invoke -> to call for with earnest desire; make supplication or pray for / to call on (a deity, Muse, etc.), as in prayer or supplication.

sincere -> genuine; real.

oblige -> make (someone) legally or morally bound to an action or course of action.

compel -> force or oblige (someone) to do something.

moreover -> in addition to what has been said; further; besides

entrepreneur -> a person who organizes and manages any enterprise, especially a business, usually with considerable initiative and risk

transcend -> to rise above or go beyond; overpass; exceed

virtue -> behavior showing high moral standards. / the good qualities inherent in a person or thing. / knowledge of or expertise in the fine arts.

cogent -> convincing or believable by virtue of forcible, clear, or incisive presentation; telling.

toggle -> switch.

extensible -> capable of being extended.

consortium -> an association, typically of several companies.

nexus -> a means of connection; tie; link.

societal -> noting or pertaining to large social groups, or to their activities, customs, etc.

punctuation -> the practice or system of using certain conventional marks or characters in writing or printing in order to separate elements and make the meaning clear, as in ending a sentence or separating clauses.

possess -> to have as belonging to one; have as property; own.

abundant -> present in great quantity; more than adequate; oversufficient.

enrich -> to supply with riches, wealth, abundant or valuable possessions.

facility -> something designed, built, installed, etc., to serve a specific function affording a convenience or service

redundant -> exceeding what is needed or useful; superfluous

convey -> to carry, bring, or take from one place to another; transport; bear

penetrate -> to pierce or pass into or through

impenetrable -> not penetrable; that cannot be penetrated, pierced, entered, etc.

opaque -> not transparent or translucent; impenetrable to light; not allowing light to pass through.

minuteness -> narrowness.

perception -> the ability to see, hear, or become aware of something through the senses. / approach, attention, attitude, awareness, concept, consciousness.

dim -> make or become less bright or distinct.

dull -> boring, dim, dumb, simple, slow.

obtuse -> not quick or alert in perception, feeling, or intellect; not sensitive or observant; dull

handful -> a small amount, number, or quantity

metaphor -> something used, or regarded as being used, to represent something else; symbol

recruit -> a new member of a group, organization, or the like

enlist -> to enroll, usually voluntarily, for military service

strip -> remove all coverings from.

strap -> a strip of leather, cloth, or other flexible material, often with a buckle, used to fasten, secure, or carry something or to hold onto something.

stripe -> a relatively long, narrow band of a different color, appearance, weave, material, or nature from the rest of a surface or thing.

acquire -> to come into possession or ownership of; get as one's own

resist -> to withstand, strive against, or oppose

vigorously -> with active strength or force; energetically or powerfully

strive -> to exert oneself vigorously; try hard

oppose -> to act against or provide resistance to; combat

compose -> to make or form by combining things, parts, or elements

compound -> composed of two or more parts, elements, or ingredients

heroic -> also heroical . of, relating to, or characteristic of a hero or heroine.

frail -> having delicate health; not robust; weak. / (of a person) weak and delicate. 

fragile -> easily broken, shattered, or damaged; delicate; brittle; frail.

delicate -> fine in texture, quality, construction, etc. / easily broken or damaged; fragile.

robust -> strong and healthy; hardy; vigorous.

brittle -> easily damaged or destroyed; fragile; frail.

juggernaut -> any large, overpowering force or object, such as war, a giant battleship, or a powerful football team

penetrate -> to pierce or pass into or through.

profound -> penetrating or entering deeply into subjects of thought or knowledge; having deep insight or understanding.

devotion -> profound dedication, especially to religion. / love, loyalty, or enthusiasm for a person, activity, or cause.

engage -> to occupy the attention or efforts of (a person or persons)

affair -> anything done or to be done; anything requiring action or effort; business; concern.

forum -> the marketplace or public square of an ancient Roman city, the center of judicial and business affairs and a place of assembly for the people

disperse -> to drive or send off in various directions; scatter

bid -> to command; order; direct.

depart -> to go away; leave

dismiss -> to direct (an assembly of persons) to disperse or go / to bid or allow (a person) to go; give permission or a request to depart

steadfast -> fixed in direction; steadily directed

rigid -> unable to bend or be forced out of shape; not flexible.

firm -> not soft or yielding when pressed; comparatively solid, hard, stiff, or rigid

remonstrance -> a protest

persist -> to continue steadfastly or firmly in some state, purpose, course of action, or the like, especially in spite of opposition, remonstrance

perseverance -> steady persistence in a course of action, a purpose, a state, etc., especially in spite of difficulties, obstacles, or discouragement

laborious -> requiring much work, exertion, or perseverance.

trivial -> of very little importance or value; insignificant.

inconsequential -> of little or no importance; insignificant; trivial.

liable -> responsible by law; legally answerable.

embed -> to fix into a surrounding mass.

sole -> being the only one of the kind.

solely -> exclusively or only.

mere -> that is solely or no more or better than what is specified.

merely -> just; only / only as specified and nothing more; simply.

aspect -> appearance to the eye or mind; look / nature; quality; character

stretch -> to draw out or extend (oneself, a body, limbs, wings, etc.) to the full length or extent (often followed by out) / to hold out, reach forth, or extend (one's arm, head, etc.)

intensify -> become or make more intense.

enhance -> to raise to a higher degree; intensify; magnify

nimble -> quick and light in movement; moving with ease

adroit -> expert or nimble in the use of the hands or body

agility -> the power of moving quickly and easily; nimbleness

dexterity -> skill in performing tasks, especially with the hands.

occupation -> a job or profession. / the action, state, or period of occupying or being occupied by military force.

craft -> an art, trade, or occupation requiring special skill, especially manual skill

reluctance -> unwillingness

linger -> to remain or stay on in a place longer than is usual or expected, as if from reluctance to leave

hover -> to keep lingering about; wait near at hand

flap -> to swing or sway back and forth loosely, especially with noise

flutter -> to wave, flap, or toss about

toss -> to throw or send from one to another, as in play

retain -> continue to have (something); keep possession of.

maintain -> to keep in existence or continuance; preserve; retain

conjunction -> the act of joining together, or the state of being so joined; combination, union, or association

bundled -> (of hardware or software) sold together, as a package, rather than separately.

descend -> move or fall downward.

descendant -> a person, plant, or animal that is descended from a particular ancestor.

descended -> having a specified ancestry or ethnic origin / having gone from a higher place or position to a lower one

ancestor -> a person from whom one is descended; forebear

pseudo -> not actually but having the appearance of; pretended; false or spurious; sham / almost, approaching, or trying to be

withdraw -> remove or take away (something) from a particular place or position. / leave or cause to leave a place or situation.

retreat -> the forced or strategic withdrawal of an army or an armed force before an enemy, or the withdrawing of a naval force from action

shrink -> to draw back, as in retreat or avoidance
 
variant -> not agreeing or conforming; differing, especially from something of the same general kind

irresistible -> not resistible; incapable of being resisted or withstood

vogue -> something in fashion, as at a particular time / popular currency, acceptance, or favor; popularity

dispose -> bring (someone) into a particular frame of mind.

disposal -> the action or process of getting rid of something. / access.

incline -> feel willing or favorably disposed toward (an action, belief, or attitude). / leaning or turning away from the vertical or horizontal; sloping.

tend -> to be disposed or inclined in action, operation, or effect to do something

prevail -> to be widespread or current; exist everywhere or generally / to appear or occur as the more important or frequent feature or element; predominate

trend -> the general course or prevailing tendency / style or vogue

commerce -> an interchange of goods or commodities, especially on a large scale between different countries (foreign commerce ) or between different parts of the same country (domestic commerce ); trade; business

compelling -> tending to compel, as to force or push toward a course of action; overpowering

integral -> of, relating to, or belonging as a part of the whole; constituent or component

integration -> an act or instance of combining into an integral whole / an act or instance of integrating a racial, religious, or ethnic group

ethnic -> pertaining to or characteristic of a people, especially a group (ethnic group ) sharing a common and distinctive culture, religion, language, or the like

excel -> to surpass others or be superior in some respect or area; do extremely well

deliberation -> careful consideration before decision / formal consultation or discussion

bestow -> present (an honor, right, or gift).

confer -> to consult together; compare opinions; carry on a discussion or deliberation / to bestow upon as a gift, favor, honor, etc.

bestow -> to present as a gift; give; confer (usually followed by on or upon)

dubbed -> given a specified name, title, nickname, or other designation

expense -> cost or charge

conversion -> the act or process of converting; state of being converted / a change in character, form, or function

merit -> the quality of being particularly good or worthy, especially so as to deserve praise or reward.

criticize -> to censure or find fault with / to judge or discuss the merits and faults of

argument -> a reason or set of reasons given with the aim of persuading others that an action or idea is right or wrong. / an exchange of diverging or opposite views, typically a heated or angry one.

settle -> resolve or reach an agreement about (an argument or problem).

pioneer -> a person who is among those who first enter or settle a region, thus opening it for occupation and development by others

strip -> to deprive of covering

characteristics -> distinguishing quality; trait, attribute

delegate -> to give (a piece of work, power etc. ) to someone else

trivial -> trifling, unimportant, insignificant, minor

mischief -> action or behavior (especially of children) that causes small troubles or annoyance to others

shenanigans -> trick, prank; mischief

rot -> (chiefly of animal or vegetable matter) decay or cause to decay by the action of bacteria and fungi; decompose.

decay -> (of organic matter) rot or decompose through the action of bacteria and fungi.

corruption -> dishonesty; immorality; decay.

substitute -> to put in, or to take, the place of someone or something else / a person or thing acting or serving in place of another.

intercept -> to stop or catch (a person, thing etc. ) before he, it etc. arrives at the place to which he, it etc. is going, being sent etc.

profess -> to state or declare openly / to claim or pretend

ostensible -> appearing to be true; professed to be a certain way (but often having hidden meaning or intent)

apparent -> obvious; ostensible, pretended

unfold -> open something that was folded; reveal, explain; become unfolded, be revealed, become apparent

quarrel -> an angry disagreement or argument

neutral -> not taking sides in a quarrel or war

settle -> to place in a position of rest or comfort / to reach a decision or agreement

conciliator -> a person who acts as a mediator between two disputing people or groups.

mediator -> intervener; peacemaker, neutral conciliator; one who mediates

quarreled -> have a heated argument or disagreement.

reconciling -> to cause (people) to become friendly again, e.g. after they have quarreled

assess -> to estimate or judge the quality or quantity of

depreciate -> to reduce the purchasing value of (money) / to lessen the value or price of

resemble -> to be like or similar to. / have qualities or features, especially those of appearance, in common with (someone or something); look or seem like.

dense -> having the component parts closely compacted together; crowded or compact

altitude -> the height of anything above a given planetary reference plane, especially above sea level on earth

glance -> to look quickly or briefly.

subordinate -> lower in rank or position.

allegiance -> loyalty or commitment of a subordinate to a superior or of an individual to a group or cause.

pursuit -> the action of following or pursuing someone or something.

devote -> to give up or appropriate to or concentrate on a particular pursuit, occupation, purpose, cause, etc.

adhere -> to stay attached; stick fast; cleave; cling (usually followed by to ), to be devoted in support or allegiance; be attached as a follower or upholder (usually followed by to )

adherence -> the quality of adhering; steady devotion, support, allegiance, or attachment

integrity -> adherence to moral and ethical principles; soundness of moral character; honesty

bandwidth -> a range of frequencies within a given band, in particular that used for transmitting a signal

conspicuous -> easily seen or noticed; readily visible or observable

seamless -> smoothly continuous or uniform in quality; combined in an inconspicuous way

vital -> of or relating to life

synthesize -> to form (a material or abstract entity) by combining parts or elements ( analyze )

proceed -> to move or go forward or onward, especially after stopping.

circumstance -> a condition, detail, part, or attribute, with respect to time, place, manner, agent, etc., that accompanies, determines, or modifies a fact or event; a modifying or influencing factor.

aviation -> the design, development, production, operation, and use of aircraft, especially heavier-than-air aircraft.

avionics -> the science and technology of the development and use of electrical and electronic devices in aviation

semantic -> of, relating to, or arising from the different meanings of words or other symbols

deceptive -> giving an appearance or impression different from the true one; misleading. ( from deceive )

deceptively -> in a way that tends to mislead or give a false impression

demonstrate -> clearly show the existence or truth of (something) by giving proof or evidence.

explicit -> fully and clearly expressed or demonstrated; leaving nothing merely implied;

idle -> not working or active; unemployed; doing nothing

increment -> something added or gained; addition; increase

instruct -> direct or command someone to do something, especially as an official order.

direct -> to manage or guide by advice, helpful information, instruction, etc.

ordain -> to enact or establish by law, edict, etc.

authoritative -> able to be trusted as being accurate or true; reliable.

direct -> to give authoritative instructions to; command; order or ordain / to manage or guide by advice, helpful information, instruction, etc.

directive -> serving to direct; directing.

acute -> sharp or severe in effect; intense.

sensation -> a physical feeling or perception resulting from something that happens to or comes into contact with the body. / a widespread reaction of interest and excitement.

intense -> existing or occurring in a high or extreme degree / acute, strong, or vehement, as sensations, feelings, or emotions.

heap -> a large amount or number of.

pile -> a heap of things laid or lying one on top of another.

heap up -> arrange into piles or stacks

accumulate -> to gather or collect, often in gradual degrees; heap up

successive -> following one another or following others.

accumulation -> the acquisition or gradual gathering of something.

cumulative -> increasing or growing by accumulation or successive additions

opt-out -> to choose not to be part of an activity or to stop being involved in it.

distract -> to draw away or divert, as the mind or attention.

antagonism -> an active hostility or opposition, as between unfriendly or conflicting groups.

hostility -> a hostile state, condition, or attitude; enmity; antagonism; unfriendliness.

hinder -> to cause delay, interruption, or difficulty in.

hindrance -> a thing that provides resistance, delay, or obstruction to something or someone.

drawback -> a hindrance or disadvantage; an undesirable or objectionable feature.

faculty -> an ability, natural or acquired, for a particular kind of action.

guardian -> a person who guards, protects, or preserves.

district -> a division of territory, as of a country, state, or county, marked off for administrative, electoral, or other purposes / a region or locality.

ward -> a division or district of a city or town, as for administrative or political purposes.

guardianship -> the position and responsibilities of a guardian, especially toward a ward.

custody -> keeping; guardianship; care.

apprehend -> to take into custody; arrest by legal warrant or authority / understand.

perceive -> to become aware of, know, or identify by means of the senses.

perception -> the act or faculty of perceiving, or apprehending by means of the senses or of the mind; cognition; understanding.

severe -> (of something bad or undesirable) very great; intense.

hone -> to make more acute or effective; improve; perfect.

sufficient -> acceptable, ample, plentiful, satisfactory, tolerable.

gullible -> easily deceived or cheated.

adequate -> as much or as good as necessary for some requirement or purpose; fully sufficient, suitable, or fit (often followed by to or for).

credulous -> willing to believe or trust too readily, especially without proper or adequate evidence; gullible.

naive -> having or showing a lack of experience, judgment, or information; credulous.

associate -> to connect or bring into relation, as thought, feeling, memory, etc.

expression -> a look on someone's face that conveys a particular emotion. / a word or phrase, especially an idiomatic one, used to convey an idea.

utter -> to give audible expression to; speak or pronounce.

utterly -> in an utter manner; completely: absolutely.

sake -> for the purpose of; in the interest of; in order to achieve or preserve.

forsake -> to quit or leave entirely; abandon; desert.

abandon -> to leave completely and finally; forsake utterly; desert.

arrogant -> making claims or pretensions to superior importance or rights; overbearingly assuming; insolently proud.

incur -> to come into or acquire (some consequence, usually undesirable or injurious).

entrust -> to charge or invest with a trust or responsibility; charge with a specified office or duty involving trust.

commission -> the act of committing or entrusting a person, group, etc., with supervisory power or authority.

diminish -> make or become less.

diminished -> reduced or lessened; made smaller.

impairment -> the state of being diminished, weakened, or damaged, especially mentally or physically. / the state or fact of a faculty or function being weakened or damaged.

spine -> any backbone like part.

paralysis -> a loss or impairment of voluntary movement in a body part, caused by injury or disease of the nerves, brain, or spinal cord.

confine -> to enclose within bounds; limit or restrict / keep or restrict someone or something within certain limits of (space, scope, or time).

restrict -> to confine or keep within limits, as of space, action, choice, intensity, or quantity

contingent -> dependent for existence, occurrence, character, etc., on something not yet certain; conditional

discretion -> the power or right to decide or act according to one's own judgment; freedom of judgment or choice

arbitrary -> subject to individual will or judgment without restriction; contingent solely upon one's discretion

cast -> to throw or hurl; fling

thrust -> push (something or someone) suddenly or violently in the specified direction.

submerge -> cause to be under water.

plunge -> to cast or thrust forcibly or suddenly into something, as a liquid, a penetrable substance, a place, etc.; immerse; submerge.

sink -> go down below the surface of something, especially of a liquid.

immerse -> to plunge into or place under a liquid; dip; sink.

deceive -> to mislead by a false appearance or statement; delude

proxy -> the agency, function, or power of a person authorized to act as the deputy or substitute for another	

realm -> a kingdom.

spatial -> of or relating to space, the three-dimensional realm or expanse in which all material objects are located and all events occur. /  relating to or occupying space.

essence -> the basic, real, and invariable nature of a thing or its significant individual feature or features.

fraught -> (of a situation or course of action) filled with or likely to result in (something undesirable).

blueprint -> a design plan or other technical drawing. / draw up (a plan or model).

swallow -> to take into the stomach by drawing through the throat and esophagus with a voluntary muscular action, as food, drink, or other substances

devour -> to swallow or eat up hungrily, voraciously, or ravenously.

drain -> to withdraw or draw off (a liquid) gradually; remove slowly or by degrees, as by filtration.

fatigue -> extreme tiredness resulting from mental or physical exertion or illness.

exhaust -> to drain of strength or energy, wear out, or fatigue greatly, as a person.

plague -> an epidemic disease that causes high mortality; pestilence.

oppressively -> brutally, hard, harshly, restrictively, tyrannically

onerous -> (of a task or responsibility) involving a great deal of effort, trouble, or difficulty.

burdensome -> oppressively heavy; onerous

cumbersome -> burdensome; troublesome

progenitor -> a biologically related ancestor.

offspring -> children or young of a particular parent or progenitor.

prolific -> producing offspring, young, fruit, etc., abundantly; highly fruitful

s -> to look at or view with continued attention; observe or study thoughtfully

speculation -> the contemplation or consideration of some subject

speculative -> pertaining to, of the nature of, or characterized by speculation, contemplation, conjecture, or abstract reasoning

latch -> a device for holding a door, gate, or the like, closed, consisting basically of a bar falling or sliding into a catch, groove, hole, etc.

concurrent -> occurring or existing simultaneously or side by side.

in a nutshell -> they are most likely summing something up in a few words.

simultaneously -> at the same time.

congruous -> exhibiting harmony of parts.

heterogeneous -> different in kind; unlike; incongruous.

homogeneous -> composed of parts or elements that are all of the same kind; not heterogeneous

conspicuous -> standing out so as to be clearly visible.

prominent -> standing out so as to be seen easily; particularly noticeable; conspicuous. / very noticeable, important, or famous.

readily -> promptly; quickly; easily.

promptly -> at once or without delay

conspicuous -> easily seen or noticed; readily visible or observable

sentiment -> an attitude toward something; regard; opinion.

referential -> having reference / containing a reference

jarring -> having a harshly unpleasant or disturbing effect on one’s nerves, feelings, thoughts, etc.

attain -> to reach, achieve, or accomplish; gain; obtain

quest -> a search or pursuit made in order to find or obtain something

cling -> hold on tightly to.

cleave -> to adhere closely; stick; cling (usually followed by to ). / to remain faithful (usually followed by to )

concentrate -> focus one's attention or mental effort on a particular object or activity.

integrity -> adherence to moral and ethical principles; soundness of moral character; honesty.

spectrum -> used to classify something in terms of its position on a scale between two extreme points.

portable -> capable of being transported or conveyed

inherent -> existing in someone or something as a permanent and inseparable element, quality, or attribute; inhering

fleet -> a group of ships sailing together, engaged in the same activity, or under the same ownership.

swift -> happening quickly or promptly; rapid.

obsolete -> no longer in general use; fallen into disuse.

inventive -> (of a person) having the ability to create or design new things or to think originally.

ingenuity -> the quality of being clever, original, and inventive.

elaborate -> worked out with great care and nicety of detail; executed with great minuteness.

devise -> to contrive, plan, or elaborate; invent from existing principles or ideas.

contrive -> to plan with ingenuity; devise; invent.

barrier -> anything built or serving to bar passage, as a railing, fence, or the like

interior -> being within; inside of anything; internal; inner; further toward a center

perimeter -> a line bounding or marking off an area

circumference -> the outer boundary, especially of a circular area; perimeter

proportion -> comparative relation between things or magnitudes as to size, quantity, number, etc.; ratio.

slender -> having a circumference that is small in proportion to the height or length.

stem -> the ascending axis of a plant, whether above or below ground, which ordinarily grows in an opposite direction to the root or descending axis.

shrub -> a woody plant smaller than a tree, usually having multiple permanent stems branching from or near the ground.

stick -> a branch or shoot of a tree or shrub that has been cut or broken off.

bent -> curved; crooked.

pliable -> easily bent; flexible; supple.

membrane -> Anatomy. a thin, pliable sheet or layer of animal or vegetable tissue, serving to line an organ, connect parts, etc.

alter -> to make different in some particular, as size, style, course, or the like; modify.

trait -> a distinguishing characteristic or quality, especially of one's personal nature.

acculturation -> the process of sharing and learning the cultural traits or social patterns of another group.

hesitation -> the action of pausing before saying or doing something.

acculturate -> to alter by acculturation, through sharing and learning the cultural traits or social patterns of another group: Older computer users are hesitant to acculturate to social media communities.

criterion -> a standard of judgment or criticism; a rule or principle for evaluating or testing something.

apparatus -> a group or combination of instruments, machinery, tools, materials, etc., having a particular function or intended for a specific use.

appliance -> an instrument, apparatus, or device for a particular purpose or use.

hoist -> to raise or lift, especially by some mechanical appliance.

lump -> a compact mass of a substance, especially one without a definite or regular shape.

clump -> a compacted mass or lump of something.

chunk -> a thick mass or lump of anything / a thick, solid piece of something.

induction -> the act of inducing, bringing about, or causing / the act of inducting; introduction; initiation.

remunerate -> to pay, recompense, or reward for work, trouble, etc.

compensate -> to recompense for something.

assert -> to state with assurance, confidence, or force; state strongly or positively; affirm; aver.

reciprocal -> given or felt by each toward the other; mutual. / given, felt, or done in return.

mutual -> possessed, experienced, performed, etc., by each of two or more with respect to the other; reciprocal.

contrary -> opposite in nature or character; diametrically or mutually opposed.

substitution -> change; exchange; swap; trade.

supervise -> to oversee (a process, work, workers, etc.) during execution or performance.

commission -> the act of committing or entrusting a person, group, etc., with supervisory power or authority.

deduct -> subtract or take away (an amount or part) from a total.

gross -> without tax or other contributions having been deducted.

outrageous -> of the nature of or involving gross injury or wrong.

defamation -> the act of defaming; false or unjustified injury of the good reputation of another, as by slander or libel; calumny.

slander -> defamation; calumny.

compass -> an instrument for determining directions, as by means of a freely rotating magnetized needle that indicates magnetic north.

discrete -> apart or detached from others; separate; distinct

vertex -> the highest point of something; apex; summit; top

departure -> leave-taking, exit, going, leaving

deviation -> departure from a standard or norm.

correlate  -> to place in or bring into mutual or reciprocal relation; establish in orderly connection

propagate -> to cause (an organism) to multiply by any process of natural reproduction from the parent stock / spread and promote (an idea, theory, etc.) widely.

regulate -> to control or direct by a rule, principle, method, etc.

methodology -> a set or system of methods, principles, and rules for regulating a given discipline, as in the arts or sciences.

stepwise -> in a steplike arrangement

refinement -> fineness or elegance of feeling, taste, manners, language, etc.

constituent -> serving to compose or make up a thing; component

decompose -> to separate or resolve into constituent parts or elements; disintegrate

cease -> bring or come to an end.

halt -> to stop; cease moving, operating, etc., either permanently or temporarily

viable -> capable of living

flop -> to fall or plump down suddenly, especially with noise; drop or turn with a sudden bump or thud (sometimes followed by down ) / to be a complete failure; fail

punchy -> being or appearing vigorously effective; forceful.

contender -> a person or group that competes against others to win something; contestant

aught -> anything whatever; any part.

adverse -> unfavorable or antagonistic in purpose or effect.

beneath -> below; in or to a lower place, position, state, or the like.

shelter -> a place giving temporary protection from bad weather or danger.

hive -> a shelter constructed for housing a colony of honeybees; beehive.

propriety -> conformity to established standards of good or proper behavior or manners.

decency -> the state or quality of being decent.

modesty -> simplicity; moderation / regard for decency of behavior, speech, dress, etc.

decent -> conforming to the recognized standard of propriety, good taste, modesty, etc., as in behavior or speech

spark -> anything that activates or stimulates; inspiration or catalyst.

conduct -> personal behavior; way of acting; bearing or deportment.

articulate -> capable of speech; not speechless.

emulate -> to try to equal or excel; imitate with effort to equal or surpass

verbose -> characterized by the use of many or too many words; wordy

comprehension -> the action or capability of understanding something.

concise -> expressing or covering much in few words; brief in form but comprehensive in scope

dozen -> a group of 12.

grind -> to wear, smooth, or sharpen by abrasion or friction; whet

diminish -> to make or cause to seem smaller, less, less important, etc.; lessen; reduce

cramming -> packing, storing

bump -> to cause to strike or collide

deviate -> to turn aside, as from a route, way, course. / depart from an established course.

venue -> the scene or locale of any action or event.

allude -> suggest or call attention to indirectly; hint at.

initiative -> an introductory act or step; leading action

empower -> to give power pow power or authority to; authorize, especially by legal or official means

thrill -> a sudden feeling of excitement and pleasure.

thrilled -> feeling very pleased or happily excited; delighted.

solid -> having three dimensions (length, breadth, and thickness), as a geometrical body or figure.

prohibited -> forbidden by authority or law.

hostile -> of, relating to, or characteristic of an enemy.

unanimous -> of one mind; in complete agreement; agreed

accord -> to be in agreement or harmony; agree.

concord -> agreement between persons, groups, nations, etc.; concurrence in attitudes, feelings, etc.; unanimity; accord.

discord -> lack of concord or harmony between persons or things.

antagonism -> an active hostility or opposition, as between unfriendly or conflicting groups.

pungent -> having a sharply strong taste or smell.

acrid -> having an irritatingly strong and unpleasant taste or smell.

bitter -> having a harsh, disagreeably acrid taste, like that of aspirin / having a sharp, pungent taste or smell; not sweet.

strife -> vigorous or bitter conflict, discord, or antagonism.

contention -> a struggling together in opposition; strife. / heated disagreement.

dispute -> to engage in argument or debate.

prolonged -> lasting a long time; lengthy.

controversy -> a prolonged public dispute, debate, or contention; disputation concerning a matter of opinion.

jurisdiction -> the right, power, or authority to administer justice by hearing and determining controversies.

anticipate -> to realize beforehand; foretaste or foresee, to expect; look forward to; be sure of / regard as probable; expect or predict.

jot -> to write or mark down quickly or briefly (usually followed by down )

fee -> a charge or payment for professional services

telecom -> a telecommunications company.

dominate -> to rule over; govern; control.

composition -> the act of combining parts or elements to form a whole.

amid -> in the middle of; surrounded by; among.

extensible -> capable of being extended. extended.

eligible -> fit or proper to be chosen; worthy of choice; desirable.

velvet -> https://poundfabrics.co.uk/cdn/shop/files/6825CDCF-AB1E-4FFD-9369-6A6B0C4473FB_1200x.jpg?v=1706782262

extent -> the space or degree to which a thing extends; length, area, volume, or scope.

estate -> a piece of landed property, especially one of large extent with an elaborate house on it

obligation -> something by which a person is bound or obliged to do certain things, and which arises out of a sense of duty or results from custom, law, etc.

uphold -> to support or defend, as against opposition or criticism

justify -> to defend or uphold as warranted or well-grounded / to show (an act, claim, statement, etc.) to be just or right

accountable -> subject to the obligation to report, explain, or justify something; responsible; answerable.

equity -> the quality of being fair or impartial; fairness; impartiality

neutral -> not taking part or giving assistance in a dispute or war between others

legitimate -> according to law; lawful

partial -> being such in part only; not total or general; incomplete: a partial payment of a debt.

abate -> to reduce in amount, degree, intensity, etc.; lessen; diminish: to abate one's enthusiasm.

subside -> to become quiet, less active, or less violent; abate

sentiment -> an attitude toward something; regard; opinion.

endurance -> the ability or strength to continue or last, especially despite fatigue, stress, or other adverse conditions; stamina

tolerance -> the act or capacity of enduring; endurance

provident -> having or showing foresight; providing carefully for the future.

expedient -> tending to promote some proposed or desired object; fit or suitable for the purpose; proper under the circumstances

judicious -> having, showing, or done with good judgment or sense.

keen -> finely sharpened, as an edge; so shaped as to cut or pierce substances readily.

discreet -> careful, reasonable.

sagacious -> having or showing acute mental discernment and keen practical sense; shrewd.

objectionable -> arousing distaste or opposition; unpleasant or offensive.

prude -> a person who is or claims to be easily shocked by matters relating to sex or nudity.

prudent -> acting with or showing care and thought for the future.

hurl -> to throw or cast down.

missile -> an object or weapon for throwing, hurling, or shooting, as a stone, bullet, or arrow.

squeeze -> to press forcibly together; compress.

obstacle -> barrier

obstruct -> to block or close up with an obstacle; make difficult to pass

stifle -> make (someone) unable to breathe properly; suffocate.

choke -> to stop the breath of by squeezing or obstructing the windpipe; strangle; stifle

defy -> to challenge the power of; resist boldly or openly

vow -> oath / promise

thrive -> to grow or develop vigorously

flourish -> to be in a vigorous state; thrive

deal out -> distribute or give something to several people

dispense -> to deal out; distribute

cordial -> friendly; warm.

incorporate -> take in or contain (something) as part of a whole; include.

unite -> to join, combine, or incorporate so as to form a single whole or unit.

distort -> make crooked or deformed.

replicate -> to bend or fold back / to repeat, duplicate, or reproduce, especially for experimental purposes / make an exact copy of; reproduce.

specify -> to mention or name specifically or definitely; state in detail

specification -> the act of specifying.

imperative -> absolutely necessary or required; unavoidable

applicative -> usable or capable of being used; practical; applicatory.

diametrically -> completely

contrary -> opposite in nature or character; diametrically or mutually opposed

contradict -> to assert the contrary or opposite of; deny directly and categorically.

astound -> shock with wonder or surprise.

upon -> immediately or very soon after / up and on; upward so as to get or be on

advent -> the arrival of a notable person, thing, or event.

reflect -> think about (sometimes)

reflecting on -> Consider or think carefully about

one cannot help but marvel at -> it is impossible not to feel a sense of admiration or wonder when considering something

sophistication -> complexity, as in design or organization.

refine -> to bring to a fine or a pure state; free from impurities

latter -> being the second mentioned of two

covenant -> an agreement.

testament -> a covenant, especially between god and humans. / a person's will, especially the part relating to personal property.

bear -> carry.

sustain -> to support, hold, or bear up from below; bear the weight of, as a structure.

undergo -> experience; pass through / to endure; sustain; suffer

endure -> to admit of; allow; bear / to hold out against; sustain without impairment or yielding; undergo.

articulate -> capable of speech; not speechless.

vacant -> having no contents; empty; void

inanimate -> not animate; lifeless

crowd -> a large number of persons gathered closely together

commerce -> social relations, especially the exchange of views, attitudes, etc.

treaty -> a formal agreement between two or more states in reference to peace, alliance, commerce, or other international relations.

truce -> an agreement or treaty establishing this.

conciliation -> a method of helping the parties in a dispute to reach agreement, esp divorcing or separating couples to part amicably

mediate -> to bring about (an agreement, accord, truce, peace, etc.) as an intermediary between parties by compromise, reconciliation, removal of misunderstanding, etc.

amicably -> with goodwill; in a friendly or peaceable way

moderate -> kept or keeping within reasonable or proper limits; not extreme, excessive, or intense:

vague -> not clearly or explicitly stated or expressed.

conception -> the act of conceiving; the state of being conceived.

notion -> a general understanding; vague or imperfect conception or idea of something.

conceive -> to form (a notion, opinion, purpose, etc.). / become pregnant with (a child).

dissect -> to examine minutely part by part; analyze.

cadaver -> a dead body, especially a human body to be dissected; corpse.

cohere -> to stick together; be united; hold fast, as parts of the same mass

presumption -> assumption of something as true. / belief on reasonable grounds or probable evidence.

helm -> the place or post of control

slack -> not tight, firm, or tense

relentless -> not easing or slackening; maintaining speed, vigor, etc.

exhaustive -> examining, including, or considering all elements or aspects; fully comprehensive.

superficial -> existing or occurring at or on the surface.

thorough -> complete with regard to every detail; not superficial or partial.

rigorous -> extremely thorough, exhaustive, or accurate.

rigorously -> in a way that is severely exacting, accurate, careful, and thorough; to a high standard

acquaint -> make someone aware of or familiar with.

acquainted -> having met.

acquaintance -> knowledge or experience of something. / a person one knows slightly, but who is not a close friend. / a person's knowledge or experience of something.

subsequent -> coming after something in time; following.

alumnus -> a graduate or former student of a particular school, college, or university.

offspring -> a person's child or children.

prolific -> (of a plant, animal, or person) producing much fruit or foliage or many offspring.

attire  -> dress, clothes

setback -> problem / difficulty / issue

camaraderie -> mutual trust and friendship among people who spend a lot of time together.

dementia -> brain damage / mental disorder

broad -> of great extent; large

recap -> a brief description of the main points

commutativity -> the fact of always giving the same result whatever order the values are in

associativity  -> when more than two numbers are added or multiplied, the result remains the same, irrespective of how they are grouped

scalar -> a quantity which is completely described by its magnitude—a numerical value and usually a unit.

extract -> to get, pull, or draw out, usually with special effort, skill, or force

hostility -> unfriendliness or opposition.

antagonistic -> showing or feeling active opposition or hostility towards someone or something.

adverse -> unfavorable or antagonistic in purpose or effect

fortune -> chance or luck as an external, arbitrary force affecting human affairs.

doom -> fate or destiny, especially adverse fate; unavoidable ill fortune

amplitude -> the vertical distance from the midline of a sine or cosine wave to a maximum or minimum of the wave.

analogy -> a similarity between like features of two things, on which a comparison may be based

wiggle -> to move or go with short, quick, irregular movements from side to side

far-flung -> distant or remote.

rigidly -> in a strict or exacting way.

erect -> rigidly upright or straight.

goosebumps -> a state of the skin caused by cold, fear, or excitement, in which small bumps appear on the surface as the hairs become erect

corpus -> a large or complete collection of writings

appoint -> assign a job or role to (someone).

designate -> appoint (someone) to a specified office or post.

unwind -> relax after a period of work or tension.

preceding -> coming before something in order, position, or time.

invoice -> an itemized bill for goods sold or services provided, containing individual prices, the total charge, and the terms.

prerequisite -> required beforehand

discrete -> apart or detached from others; separate; distinct

Danceability -> is a measure of how good a song is for dancing on a scale from 0 (terrible) to 1 (perfect).

acoustic ness -> is a measure of the lack of electrical amplification on a scale from 0 (no amplification) to 1 (total amplification).

Tempo -> is the average number of beats per minute (BPM). It measures the speed or pace of a song.

Valence -> is a measure of the positivity of a song on a scale from 0 (unhappy) to 1 (extremely happy).

Energy -> is a measure of perceived activity on a scale from 0 (no energy) to 1 (highly energetic). 

Loudness -> is a measure of a song's strength, or amplitude, in decibels (dB).

punctuation -> the practice or system of using certain conventional marks or characters in writing or printing in order to separate elements and make the meaning clear, as in ending a sentence or separating clauses.

flagship -> the best or most important one of a group or system

honing in -> to focus one's attention more narrowly or precisely on a particular task, issue, etc.

on behalf of -> in the interests of (a person, group, or principle). / as a representative of.

alleviate -> make (suffering, deficiency, or a problem) less severe. / to make easier to endure.

relieve -> to ease or alleviate (pain, distress, anxiety, need, etc.).

encounter -> to come upon or meet with, especially unexpectedly

affiliated -> being in close formal or informal association; related

infrastructure -> the basic, underlying framework or features of a system or organization

tedious -> too long, slow, or dull

proficient -> very good at doing something especially through practice.

modularity -> the quality of consisting of separate parts that, when combined, form a complete whole

consolidate -> make (something) physically stronger or more solid.

accompany -> go somewhere with (someone) as a companion or escort.

accompanying -> provided or occurring at the same time as something else.

mutate -> change in form or nature.

furious -> extremely angry.

side gig -> a piece of work or a job that you get paid for doing in addition to doing your main job

ferocious -> very great; extreme.

fierce -> having or displaying an intense or ferocious aggressiveness.

glare -> stare in an angry or fierce way.

decisive -> having or showing the ability to make decisions quickly and effectively.

rival -> a person or thing competing with another for the same objective or for superiority in the same field of activity.

precedent -> an earlier event or action that is regarded as an example or guide to be considered in subsequent similar circumstances.

unprecedented -> never done or known before.

rip someone off -> cheat someone, especially financially.

imitate -> to make a copy of; reproduce closely. / take or follow as a model.

cognitive -> relating to the mental process involved in knowing, learning, and understanding things

peer -> one that is of equal standing with another

probe -> to search into and explore very thoroughly. / physically explore or examine (something) with the hands or an instrument.

strengthen -> make or become stronger.

symptom -> a physical or mental feature which is regarded as indicating a condition of disease, particularly such a feature that is apparent to the patient.

diagnose -> identify the nature of (an illness or other problem) by examination of the symptoms.

irritate -> make (someone) annoyed or a little angry.

contentment -> a state of happiness and satisfaction.

purr -> (of a cat) make a low continuous vibratory sound expressing contentment.

temper -> a person's state of mind seen in terms of their being angry or calm.

grumble -> complain about something in a bad-tempered way.

grouch -> voice one's discontent ill-temperedly; grumble.

suitability -> the quality of being right or appropriate for a particular person, purpose, or situation.

credential -> a qualification, achievement, quality, or aspect of a person's background, especially when used to indicate their suitability for something.

competency -> the ability to do something successfully or efficiently.

comprise -> consist of; be made up of.

delimiter -> a character or symbol used in computer code that separates words, data, or characters

evidently -> in a way that is clearly seen or understood; obviously.

precision -> the quality, condition, or fact of being exact and accurate.

tailored -> (of clothes) smart, fitted, and well cut.

bespoke -> made for a particular customer or user.

aspiration -> a hope or ambition of achieving something.

aesthetics -> the branch of philosophy that deals with the principles of beauty and artistic taste.

reverberate -> (of a loud noise) be repeated several times as an echo.

resonate -> produce or be filled with a deep, full, reverberating sound.

stunning -> extremely impressive or attractive.

captivating -> capable of attracting and holding interest; charming.

presence -> the state or fact of existing, occurring, or being present.

cherish -> protect and care for (someone) lovingly.

transcend -> surpass (a person or achievement).

propose -> make an offer of marriage to someone.

insurmountable -> too great to be overcome.

depict -> represent by a drawing, painting, or other art form.

optic -> relating to the eye or vision.

mingle -> mix or cause to mix together.

distort -> give a misleading or false account or impression of.

ambient -> relating to the immediate surroundings of something.

artifact -> an object made by a human being, typically one of cultural or historical interest.

intricate -> very complicated or detailed.

hazard -> a danger or risk. / chance; probability.

deny -> state that one refuses to admit the truth or existence of.

inference > a conclusion reached on the basis of evidence and reasoning.

exploit -> make full use of and derive benefit from (a resource).

adjacent -> close to or near something

miscellaneous -> (of items or people gathered or considered together) of various types or from different sources.

assortment -> a miscellaneous collection of things or people.

criterion -> a standard for judging something

hypotenuse -> the longest side of a right-angled triangle, opposite the right angle.

abruptly -> suddenly and unexpectedly.

skeptical -> not easily convinced; having doubts or reservations.

baffling -> impossible to understand

anticipate -> to look forward to as certain

astounding -> surprisingly impressive or notable.

joyous -> full of happiness and joy.

glance -> take a brief or hurried look.

opt -> make a choice from a range of possibilities.

knack -> an acquired or natural skill at doing something.

feat -> an achievement that requires great courage, skill, or strength.

mature -> fully developed physically; full-grown.

prematurely -> before the due time; ahead of time.

boredom -> the state of feeling bored.

manifest -> clear or obvious to the eye or mind.

embody -> be an expression of or give a tangible or visible form to (an idea, quality, or feeling)..

manifestation -> an event, action, or object that clearly shows or embodies something abstract or theoretical.

adapt -> make (something) suitable for a new use or purpose; modify.

versatile -> able to adapt or be adapted to many different functions or activities.

suspense -> a state or feeling of excited or anxious uncertainty about what may happen.

defer -> to delay something until a later time; to postpone.

vulnerable -> exposed to the possibility of being attacked or harmed, either physically or emotionally.

retrieves -> to get and bring back

prior -> existing or coming before in time, order, or importance.

precedence -> the condition of being considered more important than someone or something else; priority in importance, order, or rank.

dimmer -> a device for varying the brightness of an electric light.

veil -> a piece of fine material worn by women to protect or conceal the face.

adolescence -> the period of time in a person's life when they are developing into an adult

eloquently -> in a way that gives a strong, clear message

distorted -> pulled into or appearing as a strange or unnatural shape, false or wrong

intrinsic  -> being an extremely important and basic characteristic of a person or thing

evolve -> to develop gradually, or to cause something or someone to develop gradually

frontier -> a line or border separating two countries.

illustrious -> well known, respected, and admired for past achievements.

prestigious -> having an illustrious reputation; respected.

aspiration -> a hope or ambition of achieving something.

hallucination -> an experience involving the apparent perception of something not present.

plausible -> (of an argument or statement) seeming reasonable or probable.

hypocrite -> a person who claims or pretends to have certain beliefs about what is right but who behaves in a way that disagrees with those beliefs.

imposing -> grand and impressive in appearance.

impose -> force (an unwelcome decision or ruling) on someone.

lofty -> of imposing height.

contraption -> a machine or device that appears strange or unnecessarily complicated, and often badly made or unsafe.

resist -> withstand the action or effect of.

rebellious -> showing a desire to resist authority, control, or convention.

trivial -> of little worth or importance. / of little value or importance.

petty -> of little importance; trivial

beam -> (of a light or light source) shine brightly.

conjecture -> an opinion or conclusion formed on the basis of incomplete information.

speculate -> form a theory or conjecture about a subject without firm evidence.

horizon -> the line at which the earth's surface and the sky appear to meet.

funky -> (of music) having or using a strong dance rhythm, in particular that of funk.

unsound -> not safe or robust; in poor condition.

fallacy -> a mistaken belief, especially one based on unsound arguments.

prostitute -> a person, in particular a woman, who engages in sexual activity for payment.

prone -> likely or liable to suffer from, do, or experience something unpleasant or regrettable.

breed -> a stock of animals or plants within a species having a distinctive appearance and typically having been developed by deliberate selection. / (of animals) mate and then produce offspring.

deliberate -> done consciously and intentionally.

discern -> recognize or find out.

defective -> imperfect or faulty.

equidistant -> at equal distances

sphere -> a round solid figure, or its surface, with every point on its surface equidistant from its center.

cavity -> an empty space within a solid object.	

stationary -> standing still; not moving

monetize -> earn revenue from (an asset, business, etc.).

demographics -> statistical data relating to the population and particular groups within it.

propositions -> a suggested scheme or plan of action, especially in a business context.

harness -> control and make use of (natural resources), especially to produce energy.

subtle -> making use of clever and indirect methods to achieve something. / (especially of a change or distinction) so delicate or precise as to be difficult to analyze or describe.

appealingly -> in a way that is attractive or interesting.

nuanced -> having or characterized by subtle and often appealingly complex qualities, aspects, or distinctions

consistent -> acting or done in the same way over time, especially so as to be fair or accurate.	

entice -> attract or tempt by offering pleasure or advantage.

scarcity -> insufficiency or shortness of supply

tenfold -> ten times as great or as numerous.

intertwine -> twist or twine together.

litter -> rubbish such as paper, cans, and bottles left lying in an open or public place.

sweep -> clean (an area) by brushing away dirt or litter.

figurine -> a statuette, especially one of a human form.

erect -> put together and set upright (a building, wall, or other structure).

commemorate -> recall and show respect for (someone or something).

monument -> a statue, building, or other structure erected to commemorate a notable person or event.

ornament -> a thing used to make something look more attractive but usually having no practical purpose, especially a small object such as a figurine.

pillar -> a tall vertical structure of stone, wood, or metal, used as a support for a building, or as an ornament or monument.

pursue -> follow or chase (someone or something). / follow (someone or something) in order to catch or attack them.

persecution -> hostility and ill-treatment, especially on the basis of ethnicity, religion, or sexual orientation or political beliefs.

sanctuary -> refuge or safety from pursuit, persecution, or other danger.

circumference -> the distance around something.

coop -> a cage or pen in which poultry are kept.

myriad -> a countless or extremely great number of people or things.

adopt -> choose to take up, follow, or use.

lingua franca -> a language that is adopted as a common language between speakers whose native languages are different.

superb -> very good; excellent.

opinionated person -> certain about their beliefs, and expresses their ideas strongly and often

decorate -> make (something) look more attractive by adding extra items or images to it.

singleton -> a single person or thing of the kind under consideration.

nuance -> a subtle difference in or shade of meaning, expression, or sound.

excessive -> more than is necessary, normal, or desirable; immoderate.

boast -> talk with excessive pride and self-satisfaction about one's achievements, possessions, or abilities.

methodically -> in an orderly or systematic manner.

dissect -> methodically cut up (a body or plant) in order to study its internal parts.

constitution -> a body of fundamental principles or established precedents according to which a state or other organization is acknowledged to be governed.

intangible -> unable to be touched; not having physical presence.

reside -> have one's permanent home in a particular place.

deprecate -> express disapproval of.

controversial -> causing much discussion, disagreement.

synthesis -> the combination of components or elements to form a connected whole.

synthetic -> (of a substance) made by chemical synthesis, especially to imitate a natural product. / manufactured.

hollow -> having a hole or empty space inside.

breach -> an act of breaking or failing to observe a law, agreement, or code of conduct.

receptacle -> a hollow object used to contain something.

delve -> reach inside a receptacle and search for something.

lexical -> relating to the words or vocabulary of a language.

cumbersome -> large or heavy and therefore difficult to carry or use.

susceptible -> likely or liable to be influenced or harmed by a particular thing.

worrisome -> causing anxiety or concern.

credibility -> the quality of being trusted and believed in.

hypothetical -> imagined or suggested, but perhaps not true or really happening

verdict -> an opinion or judgement.

insidiously -> in a gradual, subtle way, but with harmful effects.

undermine -> lessen the effectiveness, power, or ability of, especially gradually or insidiously. / erode the base or foundation of (a rock formation).

accordance -> conformity or agreement.

comply -> (of a person or group) act in accordance with a wish or command.

impeccable -> (of behavior, performance, or appearance) in accordance with the highest standards of propriety; faultless.

drastic -> likely to have a strong or far-reaching effect; radical and extreme.

retrieve -> get or bring (something) back from somewhere.

forum -> a meeting or medium where ideas and views on a particular issue can be exchanged.

threshold -> a level, point, or value above which something is true or will take place and below which it is not or will not.

alias -> used to indicate that a named person is also known or more familiar under another specified name.

hone -> refine or perfect (something) over a period of time.

proportional -> corresponding in size or amount to something else.

glimpse -> a momentary or partial view.

lid -> a removable or hinged cover for the top of a container.

astronomical -> relating to astronomy. / (of an amount) extremely large.

legitimately -> in a way that conforms to the law or to rules.

versatile -> able to adapt or be adapted to many different functions or activities.

deduce -> arrive at (a fact or a conclusion) by reasoning; draw as a logical conclusion.

infer -> deduce or conclude (something) from evidence and reasoning rather than from explicit statements.

tremendous -> very great in amount, scale, or intensity.

inevitable -> certain to happen; unavoidable.

abundance -> a very large quantity of something.

mitigate -> make (something bad) less severe, serious, or painful.

labor -> work, especially physical work. / work hard; make great effort.

cushion -> a bag of cloth stuffed with a mass of soft material, used as a comfortable support for sitting or leaning on.

rational -> based on or in accordance with reason or logic.

dilemma -> a situation in which a difficult choice has to be made between two or more alternatives, especially ones that are equally undesirable.

extrapolate -> extend (a graph, curve, or range of values) by inferring unknown values from trends in the known data.

converge -> (of lines) tend to meet at a point.

divergent -> tending to be different or develop in different directions.

monologue -> a long speech by one actor in a play or film, or as part of a theatrical or broadcast program.

hypothesis -> an assumption, an idea that is proposed for the sake of argument so that it can be tested to see if it might be true.

bizarre -> very strange or unusual.

insurmountable -> too great to be overcome.

surveillance -> close observation, especially of a suspected spy or criminal.

multitude -> a large number of people or things.

justification -> the action of showing something to be right or reasonable.

stir -> a slight physical movement. / move a spoon or other implement round in (a liquid or other substance) in order to mix it thoroughly.

tilt -> move or cause to move into a sloping position.

fluctuation -> an irregular rising and falling in number or amount; a variation.

innate -> inborn; natural.

gist -> the substance or general meaning of a speech or text.

negligible -> so small or unimportant as to be not worth considering; insignificant.

footing -> the basis on which something is established or operates.

cede -> give up (power or territory).

precede -> come before (something) in time.

forego -> precede in place or time.

exertion -> physical or mental effort.

strenuous -> requiring or using great exertion.

strain -> force (a part of one's body or oneself) to make a strenuous or unusually great effort.

restraint -> a measure or condition that keeps someone or something under control or within limits.

loose -> lacking moral restraint or integrity

gratitude -> the quality of being thankful; readiness to show appreciation for and to return kindness.

tribute -> an act, statement, or gift that is intended to show gratitude, respect, or admiration.

summon -> order (someone) to be present.

domesticate -> tame (an animal) and keep it as a pet or on a farm.

apocalypse -> the complete final destruction of the world 

advocate -> a person who publicly supports or recommends a particular cause or policy.

rim -> the upper or outer edge of an object, typically something circular or approximately circular.

blissfully -> in a manner characterized by extreme happiness or joy.

dawn -> the first appearance of light in the morning followed by sunrise

forgo -> omit or decline to take (something pleasant or valuable); go without.

affection -> a gentle feeling of fondness or liking.

embrace -> hold (someone) closely in one's arms, especially as a sign of affection.

obligation -> the condition of being morally or legally bound to do something.

euphoria -> a feeling or state of intense excitement and happiness.

mock -> make (something) seem laughably, unreal or impossible.

casualty -> a person killed or injured in a war or accident.

bare -> (of a person or part of the body) not clothed or covered.

insist -> demand something forcefully, not accepting refusal.

proponent -> a person who advocates a theory, proposal, or course of action.

modality -> a particular mode in which something exists or is experienced or expressed.

scrutiny -> critical observation or examination.

martyr -> a person who is killed because of their religious or other beliefs.

gaze -> look steadily and intently, especially in admiration, surprise, or thought.

forensic -> relating to or denoting the application of scientific methods and techniques to the investigation of crime.

divisive -> tending to cause disagreement or hostility between people.

testify -> give evidence as a witness in a law court.

incident -> an instance of something happening; an event or occurrence.

anecdote -> a short amusing or interesting story about a real incident or person.

depict -> represent by a drawing, painting, or other art form.

affirm -> state emphatically or publicly.

proclaim -> announce officially or publicly.

slammer -> a prison

distress -> extreme anxiety, sorrow, or pain.

misery -> a state or feeling of great physical or mental distress or discomfort.

motto -> a short sentence or phrase chosen as encapsulating the beliefs or ideals of an individual, family, or institution.

winding -> a twisting movement or course.

spiral -> a spiral curve, shape, or pattern.

rhyme -> correspondence of sound between words or the endings of words, especially when these are used at the ends of lines of poetry.

herd -> a large group of animals.

absurd -> unreasonable, illogical, or inappropriate.

allegation -> a claim or assertion that someone has done something illegal or wrong, typically one made without proof.

scent -> a distinctive smell, especially one that is pleasant.

continual -> frequently recurring; always happening.

drifter -> a person who is continually moving from place to place, without any fixed home or job.

shiver -> shake slightly and uncontrollably as a result of being cold, frightened, or excited.

slang -> a type of language that consists of words and phrases that are regarded as very informal, are more common in speech than writing, and are typically restricted to a particular context or group of people.

falter -> start to lose strength or momentum.

moonlit -> lit by the moon.

creep -> move slowly and carefully in order to avoid being heard or noticed.

denominator -> the number below the line in a vulgar fraction

esoteric -> intended for or likely to be understood by only a small number of people with a specialized knowledge or interest.

counterpart -> a person or thing that corresponds to or has the same function as another person or thing in a different place or situation.

distort -> pull or twist out of shape.

striking -> attracting attention by reason of being unusual, extreme, or prominent.

scent of linger -> it continues to exist for a long time, often much longer than expected. 

sidepiece -> A person with whom someone already in a relationship carries on a physical affair (not emotional affair) without having the intention of forming a serious relationship.

boredom -> the state of feeling bored.

intimacy -> close familiarity or friendship.

stampede -> a sudden panicked rush of a number of horses, cattle, or other animals.

disastrous -> causing great damage.

meltdown -> a disastrous collapse or breakdown.

milling -> (of a machine) designed to cut or shape metal using a rotating tool.

fine -> very small particles found in mining, milling, etc.

dust -> fine, dry powder consisting of tiny particles of earth or waste matter lying on the ground or on surfaces or carried in the air.

liability -> the state of being responsible for something, especially by law.

volatility -> liability to change rapidly and unpredictably, especially for the worse.

disorder -> a state of confusion.

gigantic -> of very great size or extent; huge or enormous.

spring -> move or jump suddenly or rapidly upward or forward.

leap -> jump or spring a long way, to a great height, or with great force.

chaos -> complete disorder and confusion.

sluggish -> slow-moving or inactive.

deflated -> having been emptied of air or gas.

wage -> a fixed regular payment earned for work or services, typically paid on a daily or weekly basis.

embark -> go on board a ship or aircraft.

detain -> keep (someone) from proceeding; hold back.

held -> keep or detain (someone).

inquest -> a discussion or investigation into something that has happened, especially something undesirable.

verdict -> a decision on a disputed issue in a civil or criminal case or an inquest.

convict -> declare (someone) to be guilty of a criminal offense by the verdict of a jury or the decision of a judge in a court of law.

conviction -> a firmly held belief or opinion.

lackluster -> lacking in vitality, force, or conviction; uninspired or uninspiring.

unwind -> relax after a period of work or tension.

heartfelt -> (of a feeling or its expression) deeply and strongly felt; sincere.

appeal -> make a serious, urgent, or heartfelt request.

fluctuation -> an irregular rising and falling in number or amount; a variation.

clumsily -> in an awkward and careless way.

tumble -> fall suddenly or clumsily.

prospect -> the possibility or likelihood of some future event occurring.

culminate -> reach a climax or point of highest development.

acutely -> (with reference to something unpleasant or unwelcome) intensely.

pensione -> a small hotel or boarding house in Italy.

affectionate -> readily feeling or showing fondness or tenderness.

stubborn -> difficult to move, remove, or cure.

gangbuster -> very successful.

stagnant -> showing no activity; dull and sluggish.

consent -> permission for something to happen or agreement to do something.

contraception -> techniques to prevent pregnancy

conducive -> making a certain situation or outcome likely or possible.

hygiene -> conditions or practices conducive to maintaining health and preventing disease, especially through cleanliness.

arouse -> evoke or awaken (a feeling, emotion, or response).

intercourse -> communication or dealings between individuals or groups.

grooming -> the practice of brushing and cleaning the coat of a horse, dog, or other animal.

trim -> make (something) neat or of the required size or form by cutting away irregular or unwanted parts.

trimming -> decoration, especially for clothing.

spill -> cause or allow (liquid) to flow over the edge of its container, especially unintentionally.

knot -> a fastening made by looping a piece of string, rope, or something similar on itself and tightening it.

fluid -> a substance that has no fixed shape and yields easily to external pressure; a gas or (especially) a liquid.

foster -> encourage the development of (something, especially something desirable).

gauge -> an instrument that measures and gives a visual display of the amount, level, or contents of something.

authentic -> of undisputed origin and not a copy; genuine.

skew -> neither parallel nor at right angles to a specified or implied line; askew; crooked.

provocative -> causing anger or another strong reaction, especially deliberately.

praise -> express warm approval or admiration of.

applause -> approval or praise expressed by clapping.

reliant -> dependent on someone or something.

attainment -> the action or fact of achieving a goal toward which one has worked.

predominance -> the state or condition of being greater in number or amount.

fiscal -> relating to government revenue, especially taxes.

regress -> return to a former or less developed state.

chaotic -> in a state of complete confusion and disorder.

handicap -> a circumstance that makes progress or success difficult.

advert -> refer to in speaking or writing.

revival -> an improvement in the condition or strength of something.

welfare -> the health, happiness, and fortunes of a person or group.

hereditary -> (of a title, office, or right) conferred by or based on inheritance.

dynasty -> a line of hereditary rulers of a country.

lodging -> a place in which someone lives or stays temporarily.

accommodate -> (of physical space, especially a building) provide lodging or sufficient space for.

influx -> an arrival or entry of large numbers of people or things.

riot -> a violent disturbance of the peace by a crowd.

proliferation -> rapid increase in numbers.

crystallize -> make or become definite and clear.

refutation -> the action of proving a statement or theory to be wrong or false.

contradiction -> a combination of statements, ideas, or features of a situation that are opposed to one another.

rebuttal -> a refutation or contradiction.

leisure -> free time.

leisurely -> without hurry.

wander -> walk or move in a leisurely, casual, or aimless way.

sovereign -> a supreme ruler, especially a monarch.

suffocate -> die or cause to die from lack of air or inability to breathe.

smother -> kill (someone) by covering their nose and mouth so that they suffocate.

bypass -> a road passing around a town or its center to provide an alternative route for through traffic.

mnemonic -> aiding or designed to aid the memory.

serpent -> a large snake.

domain -> an area of territory owned or controlled by a ruler or government.

exclude -> deny (someone) access to or bar (someone) from a place, group, or privilege.

minority -> the smaller number or part, especially a number that is less than half the whole number.

pivotal -> of crucial importance in relation to the development or success of something else.

pervade -> (especially of a smell) spread through and be perceived in every part of.

infuse -> fill; pervade.

vindication -> the action of clearing someone of blame or suspicion.

take for granted -> assume that something is true without questioning it.

fond -> having an affection or liking for.

assault -> make a physical attack on.

awry -> away from the appropriate, planned, or expected course; amiss.

potent -> having great power, influence, or effect.

cautious -> (of a person) careful to avoid potential problems or dangers.

consensus -> a general agreement.

entitle -> give (someone) a legal right or a just claim to receive or do something.

entitlement -> the fact of having a right to something.

rudimentary -> involving or limited to basic principles.

elevation -> the action or fact of elevating or being elevated.

elevation -> height above a given level, especially sea level.

contour -> an outline, especially one representing or bounding the shape or form of something.

mild -> not severe, serious, or harsh.

demolish -> pull or knock down (a building).

seizure -> the action of capturing someone or something using force.

coup -> a sudden, violent, and unlawful seizure of power from a government.

discourse -> written or spoken communication or debate.

agonizing -> causing great physical or mental pain.

lousy -> very poor or bad; disgusting.

distill -> extract the essential meaning or most important aspects of.

benign -> gentle and kindly.

primitive -> relating to, denoting, or preserving the character of an early stage in the evolutionary or historical development of something.

sheer -> nothing other than.

indulge -> allow oneself to enjoy the pleasure of.

hedonistic -> engaged in the pursuit of pleasure; sensually self-indulgent.

alleviate -> make (suffering, deficiency, or a problem) less severe.

literacy -> the ability to read and write.

psychoactive -> (chiefly of a drug) affecting the mind

revelation -> a surprising and previously unknown fact, especially one that is made known in a dramatic way.

reverence -> deep respect for someone or something.

awe -> a feeling of reverential respect mixed with fear or wonder.

emit -> produce and discharge (something, especially gas or radiation).

radiance -> light or heat as emitted or reflected by something.

glow -> give out steady light without flame. / a steady radiance of light or heat. 

implication -> the conclusion that can be drawn from something although it is not explicitly stated.

hook -> a piece of metal or other material, curved or bent back at an angle, for catching hold of or hanging things on.

hookup -> an instance of people meeting, communicating, or cooperating.

tenderness -> gentleness and kindness.

sentimental -> of or prompted by feelings of tenderness, sadness, or nostalgia.

esoteric -> intended for or likely to be understood by only a small number of people with a specialized knowledge or interest.

inhabit -> (of a person, animal, or group) live in or occupy (a place or environment).

supersede -> take the place of (a person or thing previously in authority or use); supplant.

eternity -> infinite or unending time.

outperform -> perform better than.

mediocre -> of only moderate quality; not very good.

humble -> having or showing a modest or low estimate of one's own importance.

humanoid -> having an appearance or character resembling that of a human.

manipulate -> handle or control (a tool, mechanism, etc.), typically in a skillful manner.

actuator -> a device that causes a machine or other device to operate.

cluster -> a group of similar things or people positioned or occurring closely together.

seize -> take hold of suddenly and forcibly.

hijack -> unlawfully seize (an aircraft, ship, or vehicle) in transit and force it to go to a different destination or use it for one's own purposes.

malice -> the intention or desire to do evil; ill will.

tranquil -> free from disturbance; calm.

repose -> a state of rest, sleep, or tranquility.

requiem -> (especially in the Roman Catholic Church) a Mass for the repose of the souls of the dead.

myth -> a traditional story, especially one concerning the early history of a people or explaining some natural or social phenomenon, and typically involving supernatural beings or events.

oscillate -> move or swing back and forth at a regular speed.

slither -> move smoothly over a surface with a twisting or oscillating motion.

siesta -> an afternoon rest or nap, especially one taken during the hottest hours of the day in a hot climate.

scramble -> a difficult or hurried clamber up or over something.

intervene -> come between so as to prevent or alter a result or course of events.

interfere -> take part or intervene in an activity without invitation or necessity.

exposure -> the state of being exposed to contact with something.

lakebed -> the floor or bottom of a lake.

summit -> the highest point of a hill or mountain.

ridge -> a long narrow hilltop, mountain range, or watershed.

frustration -> the feeling of being upset or annoyed, especially because of inability to change or achieve something.

seduce -> entice (someone) into sexual activity.

curtain -> https://images.app.goo.gl/o68fMFXRFsiCXPdLA

impulse -> a sudden strong and unreflective urge or desire to act.

spontaneously -> as a result of a sudden impulse and without premeditation.

contraction -> the process of becoming smaller.

dilatation -> the process of becoming bigger. 

elastic -> (of an object or material) able to resume its normal shape spontaneously after contraction, dilatation, or distortion.

taunt -> a remark made in order to anger, wound, or provoke someone.

perturb -> make (someone) anxious or unsettled.

crust -> the tough outer part of a loaf of bread.

limb -> an arm or leg of a person or four-legged animal, or a bird's wing.

genocide -> the deliberate killing of a large number of people from a particular nation or ethnic group with the aim of destroying that nation or group.

intact -> not damaged or impaired in any way; complete.

dignity -> the state or quality of being worthy of honor or respect.

catastrophe -> an event causing great and often sudden damage or suffering; a disaster.

nutrition -> the process of providing or obtaining the food necessary for health and growth.

malnutrition -> lack of proper nutrition

contestation -> the action or process of disputing or arguing.

correlation -> a mutual relationship or connection between two or more things.

empirical -> based on, concerned with, or verifiable by observation or experience rather than theory or pure logic.

evaporate -> turn from liquid into vapor.

reservoir -> a large natural or artificial lake used as a source of water supply.

contaminate -> make (something) impure by exposure to or addition of a poisonous or polluting substance.

sewage -> https://images.app.goo.gl/x43BZvVf6EpdXKN47

restoration -> the action of returning something to a former owner, place, or condition.

intermediary -> a person who acts as a link between people in order to try to bring about an agreement or reconciliation; a mediator.

vendor -> a person or company offering something for sale, especially a trader in the street.

smelt -> extract (metal) from its ore by a process involving heating and melting.

furnace -> an enclosed structure in which material can be heated to very high temperatures, e.g. for smelting metals.

forge -> make or shape (a metal object) by heating it in a fire or furnace and beating or hammering it.

breeze -> a gentle wind.

slam -> shut (a door, window, or lid) forcefully and loudly.

rage -> violent, uncontrollable anger.

flurries -> a small swirling mass of something, especially snow or leaves, moved by sudden gusts of wind.

amendment -> a minor change or addition designed to improve a text, piece of legislation, etc.

unification -> the process of being united or made into a whole.

subsequently -> after a particular thing has happened; afterward.

durable -> able to withstand wear, pressure, or damage; hard-wearing.

afar -> at or to a distance.

hogging -> keep or use all of (something) for oneself in an unfair or selfish way.

allot -> give or apportion (something) to someone as a share or task.

innocuous -> not harmful or offensive.

habitat -> the natural home or environment of an animal, plant, or other organism.

caution -> care taken to avoid danger or mistakes.

intriguing -> arousing one's curiosity or interest; fascinating.

preempt -> take action in order to prevent (an anticipated event) from happening; forestall.

viscosity -> the state of being thick, sticky, and semifluid in consistency, due to internal friction.

swoop -> (especially of a bird) move rapidly downwards through the air.

blurt -> say (something) suddenly and without careful consideration.

excluded -> deny (someone) access to or bar (someone) from a place, group, or privilege.

equidistant -> at equal distances.

clout -> influence or power, especially in politics or business.

lay -> put down, especially gently or carefully.

layout -> the way in which the parts of something are arranged or laid out.

resilient -> (of a person or animal) able to withstand or recover quickly from difficult conditions.

prompt -> done without delay; immediate.

preceding -> coming before something in order, position, or time.

intervening -> extending or occurring between events.

sonar -> a system for the detection of objects under water and for measuring the water's depth by emitting sound pulses and detecting or measuring their return after being reflected.

bearing -> relation; relevance.

inflate -> fill (a balloon, tire, or other expandable structure) with air or gas so that it becomes distended.

girder -> a large iron or steel beam or compound structure used for building bridges and the framework of large buildings.

pier -> a platform supported on pillars or girders leading out from the shore into a body of water, used as a landing stage for boats.

protrude -> extend beyond or above a surface.

bump -> a protuberance on a level surface.

vicinity -> the area near or surrounding a particular place.

suspend -> temporarily prevent from continuing or being in force or effect.

cosmopolitan -> including or containing people from many different countries.

itinerary -> a planned route or journey.

regurgitate -> repeat (information) without analyzing or comprehending it.

perish -> suffer death, typically in a violent, sudden, or untimely way.

archetype -> a very typical example of a certain person or thing.

synthesizer -> an electronic musical instrument, typically operated by a keyboard, producing a wide variety of sounds by generating and combining signals of different frequencies.

perceptible -> (especially of a slight movement or change of state) able to be seen or noticed.

embodiment -> a tangible or visible form of an idea, quality, or feeling.

keenly -> intensely

ominous -> giving the impression that something bad or unpleasant is going to happen

looming -> (of an event) seemingly about to happen and regarded as ominous or worrying.

espouse -> adopt or support (a cause, belief, or way of life).

irony -> the expression of one's meaning by using language that normally signifies the opposite, typically for humorous or emphatic effect.

ironic -> using or characterized by irony.

contempt -> the feeling that a person or a thing is beneath consideration, worthless, or deserving scorn.

sarcastic -> marked by or given to using irony in order to mock or convey contempt.

decipher -> convert (a text written in code, or a coded signal) into normal language.

durability -> the ability to withstand wear, pressure, or damage.

truncation -> the action of cutting short something.

verge -> an edge or border.

agenda -> a list of items to be discussed at a formal meeting.

triumphant -> having won a battle or contest; victorious.

presumably -> used to convey that what is asserted is very likely though not known for certain.

deficit -> the amount by which something, especially a sum of money, is too small.

contradict -> deny the truth of (a statement) by asserting the opposite.

irrigation -> the supply of water to land or crops to help growth, typically by means of channels.

urban -> in, relating to, or characteristic of a town or city.

petrified -> so frightened that one is unable to move; terrified.

deterioration -> the process of becoming progressively worse.

crumble -> break or fall apart into small fragments, especially over a period of time as part of a process of deterioration.

mend -> repair (something that is broken or damaged).

intrude -> put oneself deliberately into a place or situation where one is unwelcome or uninvited.

intrusion -> the action of intruding.

veterinarian -> https://www.google.com/imgres?q=veterinarian&imgurl=https%3A%2F%2Fres.cloudinary.com%2Fhnpb47ejt%2Fimage%2Fupload%2Fv1646258562%2Flead-gen%2Fveterinary-technician&imgrefurl=https%3A%2F%2Fwww.careerexplorer.com%2Fcareers%2Fveterinarian%2F&docid=3vXNkwEvCGcbLM&tbnid=hXv6B5DcBh3ovM&vet=12ahUKEwiJ5vqJ8ZqKAxVsV0EAHVXBATcQM3oECHMQAA..i&w=767&h=427&hcb=2&ved=2ahUKEwiJ5vqJ8ZqKAxVsV0EAHVXBATcQM3oECHMQAA

discretion -> the freedom to decide what should be done in a particular situation.

creditor -> a person or company to whom money is owed.

surpluses -> an amount of something left over when requirements have been met; an excess of production or supply over demand.

exacerbate -> make (a problem, bad situation, or negative feeling) worse.

gauge -> an instrument or device for measuring the magnitude, amount, or contents of something, typically with a visual display of such information.

coalesce -> come together to form one mass or whole.

reverence -> deep respect for someone or something.

veneration -> great respect; reverence.

scripture -> the sacred writings of Christianity contained in the Bible.

vulnerability -> the quality or state of being exposed to the possibility of being attacked or harmed, either physically or emotionally.

bidirectional -> functioning in two directions.

alternating -> (of two or more things) occurring in turn repeatedly.

interleaved -> mix (two or more digital signals) by alternating between them.

discriminate -> make an unjust or prejudicial distinction in the treatment of different categories of people, especially on the grounds of ethnicity, sex, age, or disability.

bond -> a relationship between people or groups based on shared feelings, interests, or experiences.

criteria -> a principle or standard by which something may be judged or decided.

evaluation -> the making of a judgment about the amount, number, or value of something; assessment.

turbulent -> characterized by conflict, disorder, or confusion; not controlled or calm.

sealing -> the action or process of fastening or closing something securely.

reserved -> slow to reveal emotion or opinions.

demure -> reserved, modest, and shy (typically used of a woman).

traverse -> travel across or through.

lurch -> make an abrupt, unsteady, uncontrolled movement or series of movements

taciturn -> (of a person) reserved or uncommunicative in speech; saying little.

devastation -> great destruction or damage.

impinge -> have an effect or impact, especially a negative one.

etiquette -> the customary code of polite behavior in society or among members of a particular profession or group.

agents -> a person who acts on behalf of another person or group.

coherence -> the quality of being logical and consistent.

preliminary -> an action or event preceding or preparing for something fuller or more important.

groundwork -> preliminary or basic work.

reminiscing -> indulge in enjoyable recollection of past events.

aesthetic -> concerned with beauty or the appreciation of beauty.

pedestrian -> a person walking along a road or in a developed area.

aeronautics -> the science or practice of building or flying aircraft.

inverted -> placed or lying upside down or in the opposite position, order, or arrangement from usual.

inversion -> the action of inverting something or the state of being inverted.

scattered -> occurring or found at intervals or various locations rather than all together.

yield -> produce or provide (a natural, agricultural, or industrial product).

entail -> involve (something) as a necessary or inevitable part or consequence.

abound -> exist in large numbers or amounts.

robustness -> the quality or condition of being strong and in good condition.

astonishing -> extremely surprising or impressive; amazing.

stay put -> remain somewhere without moving or being moved.

corollary -> forming a proposition that follows from one already proved.

census -> an official count or survey of a population, typically recording various details of individuals.

figures -> a number, especially one which forms part of official statistics or relates to the financial performance of a company.

parity -> the state or condition of being equal, especially regarding status or pay.

surged -> (of a crowd or a natural force) move suddenly and powerfully forward or upward.

commonplace -> not unusual; ordinary.

contemporary -> living or occurring at the same time.

bummer -> a thing that is annoying or disappointing.

prose -> written or spoken language in its ordinary form, without metrical structure.

subroutine -> a set of instructions designed to perform a frequently used operation within a program.

worship -> the feeling or expression of reverence and adoration for a deity.

deity -> a god or goddess (in a polytheistic religion).

theism -> belief in the existence of a god or gods, especially belief in one god as creator of the universe, intervening in it and sustaining a personal relation to his creatures.

despair -> the complete loss or absence of hope.

deteriorate -> become progressively worse.

spouse -> a husband or wife, considered in relation to their partner.

esoteric -> intended for or likely to be understood by only a small number of people with a specialized knowledge or interest.

dwell -> live in or at a specified place.

dwelling -> a house, apartment, or other place of residence.

ascent -> a climb or walk to the summit of a mountain or hill.

steep -> (of a slope, flight of stairs, angle, ascent, etc.) rising or falling sharply; nearly perpendicular.

a steep rock face, especially at the edge of the sea.

precipice -> a very steep rock face or cliff, especially a tall one.

illuminate -> make (something) visible or bright by shining light on it; light up.

extraordinary -> very unusual or remarkable.

confronted -> meet (someone) face to face with hostile or argumentative intent.

funeral -> the ceremonies honoring a dead person, typically involving burial or cremation.

monument -> a statue, building, or other structure erected to commemorate a famous or notable person or event.

impart -> make (information) known; communicate.

inadvertently -> without intention; accidentally.

denote -> be a sign of; indicate.

preliminary -> denoting an action or event preceding or done in preparation for something fuller or more important.

tidy -> arranged neatly and in order.

untidy -> not arranged neatly and in order.

clutter -> crowd (something) untidily; fill with clutter.

freight -> goods transported in bulk by truck, train, ship, or aircraft.

discard -> get rid of (someone or something) as no longer useful or desirable.

inauguration -> the beginning or introduction of a system, policy, or period.

tariff -> a tax or duty to be paid on a particular class of imports or exports.

efficacy -> the ability to produce a desired or intended result.

culmination -> the highest or climactic point of something, especially as attained after a long time.

pinnacle -> the most successful point; the culmination.

portray -> depict (someone or something) in a work of art or literature.

dispatch -> deal with (a task, problem, or opponent) quickly and efficiently.

overwhelm -> bury or drown beneath a huge mass.

ensnare -> catch in or as in a trap.

throughput -> the amount of material or items passing through a system or process.

convoy -> a group of ships or vehicles traveling together, typically accompanied by armed troops, warships, or other vehicles for protection.

predecessor -> a person who held a job or office before the current holder.

elapse -> (of time) pass or go by.

aviation -> the flying or operating of aircraft.

inquire -> ask for information from someone.

contiguous -> sharing a common border; touching.

quantifier -> an expression (e.g. all, some ) that indicates the scope of a term to which it is attached.

interceptor -> a person or thing that stops or catches (someone or something) going from one place to another.

retention -> the continued possession, use, or control of something.

cognizant -> having knowledge or being aware of.

consolidation -> the action or process of making something stronger or more solid.

catchphrase -> a well-known sentence or phrase, especially one that is associated with a particular famous person.

slogan -> a short and striking or memorable phrase used in advertising.

punchline -> the final phrase or sentence of a joke or story, providing the humor or some other crucial element.

tagline -> a catchphrase or slogan, especially as used in advertising, or the punchline of a joke.

snooze -> have a short, light sleep, especially during the day.

hassle -> irritating inconvenience.

merchandise -> goods to be bought and sold.

merchant -> a person or company involved in wholesale trade, especially one dealing with foreign countries or supplying merchandise to a particular trade.

stoop -> bend one's head or body forward and downward.

snapp -> to act or move with quick or abrupt motions of the body

resuscitate -> revive (someone) from unconsciousness or apparent death.

flaky -> breaking or separating easily into small thin pieces.

secede -> withdraw formally from membership of a federal union, an alliance, or a political or religious organization.

coating -> a thin layer or covering of something.

diffuse -> spread or cause to spread over a wide area or among a large number of people.

condense -> make (something) denser or more concentrated.

moisture -> water or other liquid diffused in a small quantity as vapor, within a solid, or condensed on a surface.

rust -> a reddish- or yellowish-brown flaky coating of iron oxide that is formed on iron or steel by oxidation, especially in the presence of moisture.

decree -> an official order issued by a legal authority.

revoke -> put an end to the validity or operation of (a decree, decision, or promise).

annulled -> declare invalid (an official agreement, decision, or result).

repeal -> revoke or annul (a law or congressional act).

jurisdiction -> the official power to make legal decisions and judgments.

emblematic -> serving as a symbol of a particular quality or concept; symbolic.

laborer -> a person doing unskilled manual work for wages.

treaty -> a formally concluded and ratified agreement between countries.

ratify -> sign or give formal consent to (a treaty, contract, or agreement), making it officially valid.

readmit -> admit (someone) to a place or organization again.

flee -> run away from a place or situation of danger.

lust -> very strong sexual desire.	

disguise -> give (someone or oneself) a different appearance in order to conceal one's identity.

curriculum -> the subjects comprising a course of study in a school or college.

sailor -> a person whose job it is to work as a member of the crew of a commercial or naval ship or boat, especially one who is below the rank of officer.

binge -> a period of excessive indulgence in an activity, especially eating, drinking, or taking drugs.

propel -> drive, push, or cause to move in a particular direction, typically forward.

status quo -> the existing state of affairs, especially regarding social or political issues.

agenda -> a list of items to be discussed at a formal meeting.

wield -> hold and use (a weapon or tool).

formidable -> inspiring fear or respect through being impressively large, powerful, intense, or capable.

placate -> make (someone) less angry or hostile.

rebellion -> an act of violent or open resistance to an established government or ruler.

quell -> put an end to (a rebellion or other disorder), typically by the use of force.

agitation -> a state of anxiety or nervous excitement.

pacify -> quell the anger, agitation, or excitement of.

accede -> agree to a demand, request, or treaty.

appease -> pacify or placate (someone) by acceding to their demands.

imitation -> the action of using someone or something as a model.

predicament -> a difficult, unpleasant, or embarrassing situation.

climactic -> (of an action, event, or scene) exciting or thrilling and acting as a climax to a series of events.

culmination -> the highest or climactic point of something, especially as attained after a long time.

impede -> delay or prevent (someone or something) by obstructing them; hinder.

hamper -> hinder or impede the movement or progress of.

neglect -> fail to care properly.

pragmatic -> dealing with things sensibly and realistically in a way that is based on practical rather than theoretical considerations.

stark -> severe or bare in appearance or outline.

thrusting -> the motion of pushing or lunging suddenly or violently.

jockey -> struggle by every available means to gain or achieve something.

turbulence -> violent or unsteady movement of air or water, or of some other fluid.

stature -> a person's natural height.

prosperous -> successful in material terms; flourishing financially.

coordinate -> bring the different elements of (a complex activity or organization) into a relationship that will ensure efficiency or harmony.

sealing -> the action or process of fastening or closing something securely.

blockade -> an act or means of sealing off a place to prevent goods or people from entering or leaving.

vessel -> a ship or large boat.

harbor -> a place on the coast where vessels may find shelter, especially one protected from rough water by piers, jetties, and other artificial structures.

marina -> a specially designed harbor with moorings for pleasure craft and small boats.

brag -> say something in a boastful manner.

accredited -> (of a person, organization, or course of study) officially recognized or authorized.

ambassador -> an accredited diplomat sent by a country as its official representative to a foreign country.

vouch -> assert or confirm as a result of one's own experience that something is true or accurately so described.

shrewdness -> the quality of having or showing good powers of judgement.

savvy -> shrewdness and practical knowledge; the ability to make good judgments.

enlist -> enroll or be enrolled in the armed services.

recruitment -> the action of enlisting new people in the armed forces.

commence -> begin; start.

mobility -> the ability to move or be moved freely and easily.

incur -> become subject to (something unwelcome or unpleasant) as a result of one's own behavior or actions.

confiscate -> take or seize (someone's property) with authority.

hygiene -> conditions or practices conducive to maintaining health and preventing disease, especially through cleanliness.

excrement -> waste matter discharged from the bowels; feces.

conduit -> a channel for conveying water or other fluid.

sewer -> an underground conduit for carrying off drainage water and waste matter.

swage -> waste water and excrement conveyed in sewers.

swagger -> walk or behave in a very confident and typically arrogant or aggressive way.

sanitary -> relating to the conditions that affect hygiene and health, especially the supply of sewage facilities and clean drinking water.

scaffolding -> a temporary structure on the outside of a building, made usually of wooden planks and metal poles, used by workers while building, repairing, or cleaning the building.

cardiovascular -> relating to the heart and blood vessels.

bloom -> produce flowers; be in flower.

frivolous -> not having any serious purpose or value.

bid -> offer (a certain price) for something, especially at an auction.

auction -> a public sale in which goods or property are sold to the highest bidder.

flesh -> the soft substance consisting of muscle and fat that is found between the skin and bones of an animal or a human.

herb -> any plant with leaves, seeds, or flowers used for flavoring, food, medicine, or perfume.

herbivore -> an animal that feeds on plants.

carnivore -> an animal that feeds on flesh.

omnivore -> an animal or person that eats food of both plant and animal origin.

coalition -> an alliance for combined action, especially a temporary alliance of political parties forming a government or of states.

pristine -> in its original condition; unspoiled.

disposition -> a person's inherent qualities of mind and character.

inclination -> a person's natural tendency or urge to act or feel in a particular way; a disposition or propensity.

aversion -> a strong dislike or disinclination.

mars -> to damage, spoil, or ruin the appearance or quality of something.

flaw -> a mark, fault, or other imperfection that mars a substance or object.

accountability -> the fact or condition of being accountable; responsibility.

chasm -> a deep fissure in the earth, rock, or another surface.

abyss -> a deep or seemingly bottomless chasm.

retaliate -> make an attack or assault in return for a similar attack.

infinitesimal -> extremely small.

excavate -> make (a hole or channel) by digging.

archeology -> the study of human history and prehistory through the excavation of sites and the analysis of artifacts and other physical remains.

precious -> (of an object, substance, or resource) of great value; not to be wasted or treated carelessly.

inflict -> cause (something unpleasant or painful) to be suffered by someone or something.

gnaw -> bite at or nibble something persistently.

nibble -> take small bites out of.

exorcise -> drive out or attempt to drive out (an evil spirit) from a person or place.

stride -> walk with long, decisive steps in a specified direction.

trail -> a mark or a series of signs or objects left behind by the passage of someone or something.

journal -> a newspaper or magazine that deals with a particular subject or professional activity.

tabular -> (of data) consisting of or presented in columns or tables.

skim -> go or move quickly and lightly over or on a surface or through the air.

swoop -> (especially of a bird) move rapidly downwards through the air.

farewell -> used to express good wishes on parting.

allege -> claim or assert that someone has done something illegal or wrong, typically without proof that this is the case.

alibi -> a claim or piece of evidence that one was elsewhere when an act, especially a criminal one, is alleged to have taken place.

ancillary -> providing necessary support to the primary activities or operation of an organization, institution, industry, or system.

cater -> provide.

bog -> wet muddy ground too soft to support a heavy body.

substantive -> having a firm basis in reality and therefore important, meaningful, or considerable.

annotate -> add notes to (a text or diagram) giving explanation or comment.

memo -> a written message, especially in business.

outline -> a line or set of lines enclosing or indicating the shape of an object in a sketch or diagram. / a general description or plan giving the essential features of something but not the detail.

skimming -> the action of reading something quickly so as to note only the important points.

reprise -> repeat (a piece of music or a performance).

glean -> extract (information) from various sources.

tireless -> having or showing great effort or energy.

composite -> made up of various parts or elements.

apparatus -> the technical equipment or machinery needed for a particular activity or purpose.

dilate -> make or become wider, larger, or more open.

detrimental -> tending to cause harm.

incidence -> the occurrence, rate, or frequency of a disease, crime, or something else undesirable.

coincidence -> a remarkable concurrence of events or circumstances without apparent causal connection.

rebuke -> express sharp disapproval or criticism of (someone) because of their behavior or actions.

reprimand -> a rebuke, especially an official one.

swamp -> https://www.google.com/url?sa=i&url=https%3A%2F%2Fmybestplace.com%2Fen%2Farticle%2Fmanchac-swamp-the-most-terrifying-place-in-louisiana&psig=AOvVaw0hDiO3YZWLkqsZ1HmoL8xi&ust=1745930554028000&source=images&cd=vfe&opi=89978449&ved=0CBQQjRxqFwoTCLiZu6ng-owDFQAAAAAdAAAAABAI

favorably -> with approval.

incubate -> keep something in the right conditions so it can develop or grow.

purge -> rid (someone or something) of an unwanted quality, condition, or feeling.

steer -> (of a person) guide or control the movement of (a vehicle, vessel, or aircraft), for example by turning a wheel or operating a rudder.

moron -> a stupid person.

sorrow -> a feeling of deep distress caused by loss, disappointment, or other misfortune suffered by oneself or others.

mourn -> feel or show deep sorrow or regret for (someone or their death), typically by following conventions such as the wearing of black clothes.

interim -> temporary period or something that is temporary before a final version.

stiff -> not easily bent or changed in shape; rigid.

stagger -> walk or move unsteadily, as if about to fall.

tweak -> improve (a mechanism or system) by making fine adjustments to it.

dwell on -> think or talk about something too much or for too long.

polish -> make the surface of (something) smooth and shiny by rubbing it.

inclusive -> including or covering all the services, facilities, or items normally expected or required.

reassurance -> the action of removing someone's doubts or fears.

commute -> travel some distance between one's home and place of work on a regular basis.

impersonate -> pretend to be (another person) as entertainment or in order to deceive someone.

remark -> say something as a comment; mention.

exclamation -> a sudden cry or remark, especially expressing surprise, anger, or pain.

attest -> provide or serve as clear evidence of.

certify -> attest or confirm in a formal statement.

imputation -> the assignment of a value to something by inference from the value of the products or processes to which it contributes.

solemn -> formal and dignified.

undertaking -> a formal pledge or promise to do something.

pledge -> a solemn promise or undertaking.

vivid -> producing powerful feelings or strong, clear images in the mind.

ellipse -> https://www.google.com/imgres?q=ellipse&imgurl=https%3A%2F%2Fundergroundmathematics.org%2Fglossary%2Fellipse%2Fimages%2Fellipse.png&imgrefurl=https%3A%2F%2Fundergroundmathematics.org%2Fglossary%2Fellipse&docid=kWcJ_CuaYCbSJM&tbnid=ztiGTYxQwxcG0M&vet=12ahUKEwj9-u-IzKqNAxX8VKQEHaocIDsQM3oECGEQAA..i&w=518&h=296&hcb=2&ved=2ahUKEwj9-u-IzKqNAxX8VKQEHaocIDsQM3oECGEQAA

centroid -> the center of mass of a geometric object of uniform density.

uniform -> remaining the same in all cases and at all times; unchanging in form or character.

inspect -> look at (someone or something) closely, typically to assess their condition or to discover any shortcomings.

harvest -> the process or period of gathering in crops.

liquor -> alcoholic drink, especially distilled spirits.

distill -> purify (a liquid) by vaporizing it, then condensing it by cooling the vapor, and collecting the resulting liquid.

hollow -> having a hole or empty space inside.

acronym -> an abbreviation formed from the initial letters of other words and pronounced as a word (e.g. ASCII, NASA ).

rebellion -> an act of violent or open resistance to an established government or ruler.

revolt -> rise in rebellion.

munition -> military weapons, ammunition, equipment, and stores.

aggregate -> a whole formed by combining several (typically disparate) elements.

disparate -> essentially different in kind; not allowing comparison.

admissible -> acceptable or valid, especially as evidence in a court of law.

obese -> very fat or overweight.

inhibited -> unable to act in a relaxed and natural way because of self-consciousness or mental restraint.

overawe -> impress (someone) so much that they become silent or inhibited.

intimidate -> frighten or overawe (someone), especially in order to make them do what one wants.

crane -> a large, tall machine used for moving heavy objects by suspending them from a projecting arm or beam.

influx -> an arrival or entry of large numbers of people or things.

hinge -> https://essentracomponents.bynder.com/transform/089cc9fa-e838-4cb2-af0d-e47a98c13aca/1057558_Types-hinges_1460x500px-jpg

buckle -> a flat, typically rectangular frame with a hinged pin, used for joining the ends of a belt or strap.

leash -> a strap or cord for restraining and guiding a dog or other animal.

fudge -> present or deal with (something) in a vague, noncommittal, or inadequate way, especially so as to conceal the truth or mislead.

naysayer -> a person who criticizes, objects to, or opposes something.

agitate -> make (someone) troubled or nervous.

fluster -> make (someone) agitated or confused.

distraught -> deeply upset and agitated.

frantic -> wild or distraught with fear, anxiety, or other emotion.

lease -> a contract by which one party conveys land, property, services, etc. to another for a specified time, usually in return for a periodic payment.

municipality -> a city or town that has corporate status and local government.

crutch -> https://encrypted-tbn0.gstatic.com/images?q=tbn:ANd9GcR0GbDbvmfY2vT7gMsZZfRyev3yTDuimYqKQQ&s

autarky -> economic independence or self-sufficiency.

unanimous -> (of two or more people) fully in agreement.

transact -> conduct or carry out (business).

bureau -> an office or department for transacting particular business.

intonation -> the rise and fall of the voice in speaking.

resolution -> a firm decision to do or not to do something.

cue -> a thing said or done that serves as a signal to an actor or other performer to enter or to begin their speech or performance.

rep -> a representative.

misfortune -> bad luck.

compassion -> sympathetic pity and concern for the sufferings or misfortunes of others.

pity -> the feeling of sorrow and compassion caused by the suffering and misfortunes of others.

composure -> the state or feeling of being calm and in control of oneself.

entail -> involve (something) as a necessary or inevitable part or consequence.

gambit -> a device, action, or opening remark, typically one entailing a degree of risk, that is calculated to gain an advantage.

fumble -> use the hands clumsily while doing or handling something.

interject -> say (something) abruptly, especially as an aside or interruption.

nod -> lower and raise one's head slightly and briefly, especially in greeting, or understanding, or to give someone a signal.

fluke -> an unlikely chance occurrence, especially a surprising piece of luck.

iterative -> relating to or involving iteration, especially of a mathematical or computational process.

mechanism -> a system of parts working together in a machine; a piece of machinery.

system -> a set of things working together as parts of a mechanism or an interconnecting network.

mercenary -> primarily concerned with making money at the expense of ethics.

hotshot -> an important or exceptionally able person.

airtight -> not allowing air to escape or pass through.

corrode -> destroy or damage (metal, stone, or other materials) slowly by chemical action.

alloy -> a metal made by combining two or more metallic elements, especially to give greater strength or resistance to corrosion.

crispr -> a segment of DNA containing short repetitions of base sequences, involved in the defense mechanisms of prokaryotic organisms to viruses.

grin -> smile broadly, especially in an unrestrained manner and with the mouth open.

mischievous -> (of a person, animal, or their behavior) causing or showing a fondness for causing trouble in a playful way.

falter -> start to lose strength or momentum.

shrug -> raise (one's shoulders) slightly and momentarily to express doubt, ignorance, or indifference.

worn out -> (of a person or animal) extremely tired; exhausted.

sting -> wound or pierce with a sting.

forethought -> careful consideration of what will be necessary or may happen in the future.

impulsive -> acting or done without forethought.

bargain -> an agreement between two or more parties as to what each party will do for the other.

haggle -> dispute or bargain persistently, especially over the cost of something.

inchoate -> just begun and so not fully formed or developed

fictitious -> not real or true, being imaginary or having been fabricated.

symptom -> a physical or mental feature which is regarded as indicating a condition of disease, particularly such a feature that is apparent to the patient.

punctual -> happening or doing something at the agreed or proper time.

stingy -> unwilling to give or spend; ungenerous.

residual -> a quantity remaining after other things have been subtracted or allowed for.

edifice -> a building, especially a large, imposing one.

receptive -> willing to consider or accept new suggestions and ideas.

attune -> make receptive or aware.

old school -> used, usually approvingly, to refer to someone or something that is old-fashioned or traditional.

ritual -> a religious or solemn ceremony consisting of a series of actions performed according to a prescribed order.

observance -> the action or practice of fulfilling or respecting the requirements of law, morality, or ritual.

enforcement -> the act of compelling observance of or compliance with a law, rule, or obligation.

captor -> a person or animal that catches or confines another.

botched -> (of a task) carried out badly or carelessly.

deranged -> crazy; insane.

unhinged -> mentally unbalanced; deranged.

squarely -> directly, without deviating to one side.

resort -> turn to and adopt (a strategy or course of action, especially a disagreeable or undesirable one) so as to resolve a difficult situation.

epitomize -> be a perfect example of.

advertent -> giving attention.

omission -> a person or thing that has been left out or excluded.

intervention -> the action or process of intervening.

mutate -> change or cause to change in form or nature.

placebo -> a harmless pill, medicine

temporal -> relating to time.

catchphrase -> a well-known sentence or phrase, especially one that is associated with a particular famous person.

exemption -> the process of freeing or state of being free from an obligation or liability imposed on others.

prescription -> an instruction written by a medical practitioner that authorizes a patient to be provided a medicine or treatment.

discipline -> a branch of knowledge, typically one studied in higher education. / order

practitioner -> a person actively engaged in an art, discipline, or profession, especially medicine.

rigidity -> inability to be to bent or be forced out of shape.

dogmatic -> strongly opinionated and often unwilling to consider other views

prosperity -> having what you need to live well	

persuade -> cause (someone) to do something through reasoning or argument.

prompting -> the action of saying something to persuade, encourage, or remind someone to do or say something.

fervor -> intense and passionate feeling.

disillusionment -> a feeling of disappointment resulting from the discovery that something is not as good as one believed it to be.

moor -> make fast (a boat) by attaching it by cable or rope to the shore or to an anchor.

anchor -> moor (a ship) to the sea bottom with an anchor.

doctrine -> a belief or set of beliefs held and taught by a Church, political party, or other group.

escalation -> a rapid increase; a rise.

venue -> the place where something happens, especially an organized event such as a concert, conference, or sports event.

pinch -> grip (something, typically someone's flesh) tightly and sharply between finger and thumb.

destined -> (of a person's future) developing as though according to a plan.

inflate -> fill (a balloon, tire, or other expandable structure) with air or gas so that it becomes distended.

safeguard -> protect from harm or damage with an appropriate measure.

spare -> additional to what is required for ordinary use. / safeguard.

censure -> express severe disapproval of (someone or something), especially in a formal statement.

condemn -> express complete disapproval of, typically in public; censure.

knot -> a fastening made by tying a piece of string, rope, or something similar.

cheer -> shout for joy or in praise or encouragement.

furtive -> attempting to avoid notice or attention, typically because of guilt or a belief that discovery would lead to trouble.

sneak -> move or go in a furtive or stealthy manner.

gleam -> shine brightly, especially with reflected light.

pale -> light in color or having little color.

lethal -> sufficient to cause death.

prey -> an animal that is caught and killed by another for food.

gut -> the stomach or belly.

infiltration -> the action of entering or gaining access to an organization or place surreptitiously, especially in order to acquire secret information or cause damage.

surreptitious -> kept secret, especially because it would not be approved of.

allure -> the quality of being powerfully and mysteriously attractive or fascinating.

exotic -> originating in or characteristic of a distant foreign country.

glamorous -> attractive or appealing in an exotic or exciting way.

blurt -> say (something) suddenly and without careful consideration.

torment -> severe physical or mental suffering.

luxe -> luxury.

encompass -> surround and have or hold within.

revert -> return to (a previous state, practice, topic, etc.).

rejoice -> feel or show great joy or delight.

fiend -> an evil spirit or demon.

sew -> join, fasten, or repair (something) by making stitches with a needle and thread or a sewing machine.

seam -> a line along which two pieces of fabric are sewn together in a garment or other article.

prolong -> extend the duration of.

feud -> a prolonged and bitter quarrel or dispute.

shove -> push (someone or something) roughly.

tutor -> a private teacher, typically one who teaches a single student or a very small group.

extravagance -> lack of restraint in spending money or use of resources.

solitude -> the state or situation of being alone.

detonate -> explode or cause to explode.

strenuous -> requiring or using great exertion.

arduous -> involving or requiring strenuous effort; difficult and tiring.

undergo -> experience or be subjected to (something, typically something unpleasant, painful, or arduous).

fission  -> the action of dividing or splitting something into two or more parts.

fissile -> (of an atom or element) able to undergo nuclear fission.

struck -> hit forcibly and deliberately with one's hand or a weapon or other implement.

swollen -> (especially of a part of the body) become larger or rounder in size, typically as a result of an accumulation of fluid.

inflammation -> a localized physical condition in which part of the body becomes reddened, swollen, hot, and often painful, especially as a reaction to injury or infection.

encephalitis -> inflammation of the brain, caused by infection or an allergic reaction.

metonym -> a word, name, or expression used as a substitute for something else with which it is closely associated. For example, Washington is a metonym for the federal government of the US.

pretense -> an attempt to make something that is not the case appear true.

hypocrisy -> the practice of claiming to have moral standards or beliefs to which one's own behavior does not conform; pretense.

yelp -> a short, sharp cry, especially of pain or alarm.

smuggle -> move (goods) illegally into or out of a country.

spike -> a sharp increase in the magnitude or concentration of something.

strait -> a narrow passage of water connecting two seas or two other large areas of water.

harass -> subject to aggressive pressure or intimidation.

audacious -> showing a willingness to take surprisingly bold risks.

philanthropy -> the desire to promote the welfare of others, expressed especially by the generous donation of money to good causes.

grid -> a network of lines that cross each other to form a series of squares or rectangles.

exogenous -> relating to or developing from external factors.

synthesis -> the combination of ideas to form a theory or system.

erode -> (of wind, water, or other natural agents) gradually wear away (soil, rock, or land).

wear -> damage, erode, or destroy by friction or use.

pothole -> a depression or hollow in a road surface caused by wear or sinking; become submerged.

intoxicated -> drunk or under the influence of drugs.

transient -> lasting only for a short time; impermanent.

delirium -> a disturbed state of mind or consciousness, especially an acute, transient condition associated with fever, intoxication, and certain other physical disorders, characterized by symptoms such as confusion, disorientation, agitation, and hallucinations.

aforementioned -> denoting a thing or person previously mentioned.

divine -> of, from, or like God or a god.

rite -> a religious or other solemn ceremony or act.

bless -> pronounce words in a religious rite, to confer or invoke divine favor upon; ask God to look favorably on.

siren -> a device that makes a loud prolonged sound as a signal or warning.

preside -> be in the position of authority in a meeting or other gathering.

rupture -> (especially of a pipe, a vessel, or a bodily part such as an organ or membrane) break or burst suddenly.

bruise -> an injury appearing as an area of discolored skin on the body, caused by a blow or impact rupturing underlying blood vessels.

promo -> a piece of publicity or advertising, especially in the form of a short film or video.

dismissal -> the act of ordering or allowing someone to leave.

dissolution -> the closing down or dismissal of an assembly, partnership, or official body.

rendezvous -> a meeting at an agreed time and place, typically between two people.

tryst -> a private romantic rendezvous between lovers.

relapse -> (of someone suffering from a disease) suffer deterioration after a period of improvement.

drifter -> a person who is continually moving from place to place, without any fixed home or job.

windmill -> https://www.google.com/url?sa=i&url=https%3A%2F%2Fen.wikipedia.org%2Fwiki%2FWindmill&psig=AOvVaw3KwsSUiBLNSAaHbfVujlrk&ust=1754408394544000&source=images&cd=vfe&opi=89978449&ved=0CBUQjRxqFwoTCKjUp9y-8Y4DFQAAAAAdAAAAABAL

aspire -> direct one's hopes or ambitions towards achieving something.
	
hefty -> large, heavy, and powerful.

plausible -> (of an argument or statement) seeming reasonable or probable.

heartstring -> used in reference to one's deepest feelings of love or compassion.

yearn -> have an intense feeling of longing for something, typically something that one has lost or been separated from.

longing -> a yearning desire.

anonymize -> remove identifying particulars or details from (something, especially medical test results), typically for statistical or other purposes.

paramount -> more important than anything else; supreme.

lapse -> a temporary failure of concentration, memory, or judgment.

ecological -> relating to or concerned with the relation of living organisms to one another and to their physical surroundings.

incinerate -> destroy (something, especially waste material) by burning.

drastically -> in a way that is likely to have a strong or far-reaching effect.

reigning -> occupying the throne; ruling.

strand -> leave (someone) without the means to move from somewhere.

cast away -> a person who has been shipwrecked and stranded in an isolated place.

recurring -> occurring again periodically or repeatedly.

resurgence -> an increase or revival after a period of little activity, popularity, or occurrence.

demographic -> relating to the structure of populations.

penalize -> subject to some form of punishment.

scholar -> a specialist in a particular branch of study, especially the humanities; a distinguished academic.

citation -> a quotation from or reference to a book, paper, or author, especially in a scholarly work.

impute -> represent (something, especially something undesirable) as being done, caused, or possessed by someone; attribute.

commencement -> a beginning or start.

overdue -> not having arrived, happened, or been done by the expected time.

kindle -> light or set on fire.

restitution -> the restoration of something lost or stolen to its proper owner.

screw -> https://upload.wikimedia.org/wikipedia/commons/4/4c/Screws.jpg

stunt -> prevent from growing or developing properly.

toddler -> a young child who is just beginning to walk.

wriggle -> twist and turn with quick writhing movements.

squirm -> wriggle or twist the body from side to side, especially as a result of nervousness or discomfort.

trip -> catch one's foot on something and stumble or fall.

stumble -> trip or momentarily lose one's balance; almost fall.

dazzle -> (of a bright light) blind (a person) temporarily.

concession -> a thing that is granted, especially in response to demands; a thing conceded.

interpolate -> insert (something of a different nature) into something else.

stewardship -> the job of supervising or taking care of something, such as on organization or property.

prune -> trim (a tree, shrub, or bush) by cutting away dead or overgrown branches or stems, especially to increase fruitfulness and growth.

autonomous -> (of a country or region) having the freedom to govern itself or control its own affairs.

depot -> a place for the storage of large quantities of equipment, food, or some other commodity.

weep -> shed tears.

blade -> the flat cutting edge of a knife, saw, or other tool or weapon.

metamorphic -> denoting or relating to rock that has undergone transformation by heat, pressure, or other natural agencies.

slate -> a fine-grained gray, green, or bluish metamorphic rock easily split into smooth, flat pieces.

quarry -> a place, typically a large, deep pit, from which stone or other materials are or have been extracted.

chamber -> a large room used for formal or public events.

revolver -> a pistol with revolving chambers enabling several shots to be fired without reloading.

intimate -> closely acquainted; familiar, close.

consecrate -> make or declare (something, typically a church) sacred; dedicate formally to a religious or divine purpose.

communion -> the sharing or exchanging of intimate thoughts and feelings, especially when the exchange is on a mental or spiritual level.

altar -> the table in a Christian church at which the bread and wine are consecrated in communion services.

tease -> make fun of or attempt to provoke (a person or animal) in a playful way.

glitter -> shine with a bright, shimmering reflected light.

brook -> a small stream. / a small river.

cord -> thin, flexible string or rope made from several twisted strands.

whisper -> speak very softly using one's breath without one's vocal cords, especially for the sake of privacy.

hardened -> having become or been made hard or harder.

scorn -> the feeling or belief that someone or something is worthless.

contempt -> the feeling that a person or a thing is beneath consideration, worthless, or deserving scorn.

sarcasm -> the use of irony to mock or convey contempt.

indignation -> anger or annoyance provoked by what is perceived as unfair treatment.

resentment -> bitter indignation at having been treated unfairly.

prick -> make a small hole in (something) with a sharp point; pierce slightly.

pinprick -> a prick caused by a pin.

recede -> go or move back or further away from a previous position.

pad -> fill or cover (something) with soft material in order to protect it or its contents, make it more comfortable, or give it a particular shape.

bustle -> move in an energetic or noisy manner.

aisle -> a passage between rows of seats in a building such as a church or theater, an airplane, or a train.

ham -> overact.

stratum -> a layer or a series of layers of rock in the ground. / a level or class to which people are assigned according to their social status, education, or income.

dissertation -> a long essay on a particular subject, especially one written as a requirement for the Doctor of Philosophy degree.

terminology -> the body of terms used with a particular technical application in a subject of study, profession, etc.

incumbent -> necessary for (someone) as a duty or responsibility.

behoove -> it is a duty or responsibility for someone to do something; it is incumbent on.

banish -> send (someone) away from a country or place as an official punishment.

gist -> the substance or essence of a speech or text.

appetite -> a natural desire to satisfy a bodily need, especially for food.

discrepancy -> a lack of compatibility or similarity between two or more facts.

ubiquitous -> present, appearing, or found everywhere.

demarcate -> set the boundaries or limits of.

drag -> pull (someone or something) along forcefully, roughly, or with difficulty.

delinquent -> (typically of a young person or that person's behavior) showing or characterized by a tendency to commit crime, particularly minor crime.

default -> (in banking system) failure to fulfill an obligation, especially to repay a loan or meet financial commitments.

convolution -> a thing that is complex and difficult to follow.

capstone -> a stone fixed on top of something, typically a wall.

fiddle around -> to engage in aimless or unimportant activity, often for an extended period, to waste time, or to make minor, uncertain changes to something without a real purpose.

solicit -> ask for or try to obtain (something) from someone.

latent -> (of a quality or state) existing but not yet developed or manifest; hidden or concealed.

taxonomic -> concerned with the classification of things, especially organisms.

dendrogram -> a tree diagram, especially one showing taxonomic relationships.

surname -> a hereditary name common to all members of a family, as distinct from a given name / last name.

supplement - > something that completes or enhances something else when added to it.

supplementary -> completing or enhancing something.

subsidiary -> less important than but related or supplementary to something.

affiliate -> officially attach or connect (a subsidiary group or a person) to an organization.

patron -> a person who gives financial or other support to a person, organization, cause, or activity.

parentage -> the identity and origins of one's parents.

veteran -> he was a veteran of the big screen

specimen -> an individual animal, plant, piece of a mineral, etc., used as an example of its species or type for scientific study or display.

propagate -> breed specimens of (a plant or animal) by natural processes from the parent stock.

conscience -> an inner feeling or voice viewed as acting as a guide to the rightness or wrongness of one's behavior.
	
interoperate -> work in conjunction with each other.

drone -> make a continuous low humming sound.

entity -> a thing with distinct and independent existence.

congest -> crowd (a road or place) so as to hinder or prevent freedom of movement.

mortgage -> convey (a property) to a creditor as security on a loan.

sequestration -> the action of taking legal possession of assets until a debt has been paid or other claims have been met.

refrain -> stop oneself from doing something.

waive -> refrain from insisting on or using (a right or claim).

binding -> (of an agreement or promise) involving an obligation that cannot be broken.

pale -> light in color or having little color.

peasant -> a poor farmer of low social status who owns or rents a small piece of land for cultivation (chiefly in historical use or with reference to subsistence farming in poorer countries).

subsistence -> the action or fact of maintaining or supporting oneself at a minimum level.

cultivate -> prepare and use (land) for crops or gardening. / try to acquire or develop (a quality or skill).

bloom -> a flower, especially one cultivated for its beauty.

blush -> show shyness, embarrassment, or shame by becoming red in the face.

sugarcoat -> make something seem more pleasant, acceptable, or less harsh than it really is.

crystal -> clear and transparent like crystal.

deck -> https://www.google.com/url?sa=i&url=https%3A%2F%2Fen.wikipedia.org%2Fwiki%2FDeck_%2528building%2529&psig=AOvVaw08fodOeyDWZWO4NkGm93Zt&ust=1757349719464000&source=images&cd=vfe&opi=89978449&ved=0CBUQjRxqFwoTCNjP6oCMx48DFQAAAAAdAAAAABAM

deckchair -> a folding chair of wood and canvas, typically used near the sea or on the deck of passenger ships.

lawn -> an area of short, mown grass in a yard, garden, or park.

starry -> full of or lit by stars.

inferno -> a large fire that is dangerously out of control.

resound -> (of a sound, voice, etc.) fill a place with sound; be loud enough to echo.

precursor -> a person or thing that comes before another of the same kind; a forerunner.

seal -> a device or substance that is used to join two things together so as to prevent them from coming apart or to prevent anything from passing between them.

envelope -> a flat paper container with a sealable flap, used to enclose a letter or document.

jargon -> special words or expressions that are used by a particular profession or group and are difficult for others to understand.

buzzword -> a word or phrase, often an item of jargon, that is fashionable at a particular time or in a particular context.

prevalent -> widespread in a particular area or at a particular time.

literary -> concerning the writing, study, or content of literature, especially of the kind valued for quality of form.

colloquial -> (of language) used in ordinary or familiar conversation; not formal or literary.

insulate -> protect (something) by interposing material that prevents the loss of heat or the intrusion of sound.

interpose -> place or insert between one thing and another.

attenuation -> the reduction of the force, effect, or value of something.

choir -> an organized group of singers, typically one that takes part in church services or performs regularly in public.

conductor -> a person who directs the performance of an orchestra or choir.

terrestrial -> of, on, or relating to the earth.

archaic -> very old or old-fashioned.

compartment -> a separate section of a structure or container in which certain items can be kept separate from others.

stall -> To delay or stop progress intentionally. / A small enclosed area or compartment.

swarm -> a large or dense group of insects, especially flying ones.

chunk -> a thick, solid piece of something.

canon -> a general law, rule, principle, or criterion by which something is judged.

canonical -> according to or ordered by canon law.

hindsight -> understanding of a situation or event only after it has happened or developed.

foe -> an enemy or opponent.

vegetation -> plants considered collectively, especially those found in a particular area or habitat.

bleak -> (of an area of land) lacking vegetation and exposed to the elements.

dreary -> dull, bleak, and lifeless; depressing.

dismal -> depressing; dreary.

sparing -> moderate; economical.

frugal -> sparing or economical with regard to money or food.

parsimonious -> unwilling to spend money or use resources; stingy or frugal.

noxious -> harmful, poisonous, or very unpleasant.

benevolent -> well meaning and kindly.

contemplate -> look thoughtfully for a long time at.

eerie -> strange and frightening.

turquoise -> strange and frightening.

frailty -> the condition of being weak and delicate.

tremble -> (of a person or part of the body) shake involuntarily, typically as a result of anxiety, excitement, or frailty.

quiver -> tremble or shake with a slight rapid motion.

waver -> shake with a quivering motion.

resolute -> admirably purposeful, determined, and unwavering.

stroke -> a sudden occurrence of something.

dizzy -> having or involving a sensation of spinning around and losing one's balance.

ember -> a small piece of burning or glowing coal or wood in a dying fire.

encumber -> restrict or burden (someone or something) in such a way that free action or movement is difficult.

unfurl -> make or become spread out from a rolled or folded state, especially in order to be open to the wind.

pave -> cover (a piece of ground) with concrete, asphalt, stones, or bricks.

stray -> move away aimlessly from a group or from the right course or place.

cinch -> an extremely easy task.

pimp -> a man who controls prostitutes and arranges clients for them, taking part of their earnings in return.

inquiry -> an act of asking for information.

seize -> take hold of suddenly and forcibly.

acclaimed -> publicly praised; celebrated.

seldom -> not often; rarely.

splendid -> magnificent; very impressive.

sumptuous -> splendid and expensive-looking.

banquet -> an elaborate and formal meal for many people.

lavish -> sumptuously rich, elaborate, or luxurious.

flatter -> lavish insincere praise and compliments upon (someone), especially to further one's own interests.

vain -> having or showing an excessively high opinion of one's appearance, abilities, or worth.

guts -> the internal organs in your belly (stomach, intestines, etc.). / having the nerve to do something risky.

heed -> pay attention to; take notice of.

reck -> pay heed to something.

reckless -> (of a person or their actions) without thinking or caring about the consequences of an action.

tipping point -> the point at which a series of small changes or incidents becomes significant enough to cause a larger, more important change.

mundane -> lacking interest or excitement; dull.

itinerary -> a planned route or journey.

fidget -> make small movements, especially of the hands and feet, through nervousness or impatience.

torso -> the trunk of the human body.

belittle -> make (someone or something) seem unimportant.

staple -> https://upload.wikimedia.org/wikipedia/commons/d/df/Office-staples.jpg / main or important, especially in terms of consumption.

squash -> crush or squeeze (something) with force so that it becomes flat, soft, or out of shape.

palpable -> (of a feeling or atmosphere) so intense as to seem almost tangible.

implicate -> police claims implicated him in many more killings

complicit -> involved with others in an illegal activity or wrongdoing.

shallow -> of little depth.

reminisce -> indulge in enjoyable recollection of past events.

reminiscent -> tending to remind one of something.

accolade -> an award or privilege granted as a special honor or as an acknowledgment of merit.

outrageous -> shockingly bad or excessive.

centerpiece -> a decorative piece or display placed in the middle of a dining or serving table.

flaunt -> display (something) ostentatiously, especially in order to provoke envy or admiration or to show defiance.

gloom -> partial or total darkness.

attorney -> a person appointed to act for another in business or legal matters.

prosecutor -> a person, especially a public official, who institutes legal proceedings against someone.

tonic -> a medicinal substance taken to give a feeling of vigor or well-being.

tenant -> a person who occupies land or property rented from a landlord.

gab -> talk at length, typically about trivial matters.

shack -> a roughly built hut or cabin.

bank -> the land alongside or sloping down to a river or lake.

authentic -> of undisputed origin; genuine.

spoken -> speaking in a specified way.

vase -> a decorative container, typically made of glass or china and used as an ornament or for displaying cut flowers.

fairytale -> a children's story about magical and imaginary beings and lands.

nuisance -> a person, thing, or circumstance causing inconvenience or annoyance.

bud -> a compact growth on a plant that develops into a leaf, flower, or shoot.

prey -> an animal that is caught and killed by another for food.

bait -> food used to entice fish or other animals as prey.

temptation -> the desire to do something, especially something wrong or unwise.

linger -> stay in a place longer than necessary because of a reluctance to leave.

pensive -> engaged in, involving, or reflecting deep or serious thought.

melancholic -> feeling or expressing pensive sadness.

wistful -> having or showing a feeling of vague or regretful longing.

infatuate -> be inspired with an intense but short-lived passion or admiration for.

boulder -> a large rock, typically one that has been worn smooth by erosion.

celestial -> positioned in or relating to the sky, or outer space as observed in astronomy.

cosmetic -> involving or relating to treatment intended to restore or improve a person's appearance.

cosmic -> relating to the universe or cosmos, especially as distinct from the earth.

reproachful -> expressing disapproval or disappointment.

remonstrate -> make a forcefully reproachful protest.

scold -> remonstrate with or rebuke (someone) angrily.
	
upbraid -> find fault with (someone); scold.

wither -> (of a plant) become dry and shriveled.

fatalistic -> relating to or characteristic of the belief that all events are predetermined and therefore inevitable.
	
confrontation -> a hostile or argumentative meeting or situation between opposing parties.

indoctrinate -> teach (a person or group) to accept a set of beliefs uncritically.

antagonize -> cause (someone) to become hostile or angry.

gratification -> pleasure, especially when gained from the satisfaction of a desire.

sensual -> relating to or involving gratification of the senses and physical, especially sexual, pleasure.

prenatal -> before birth; during or relating to pregnancy.

fetus -> an offspring of a human or other mammal in the stages of prenatal development that follow the embryo stage (in humans taken as beginning eight weeks after conception).

gestate -> carry a fetus in the womb from conception to birth.

uterus -> the organ in the lower body of a woman or female mammal where offspring are conceived and in which they gestate before birth; the womb.

eradicate -> destroy completely; put an end to.

fertilize -> cause (an egg, female animal, or plant) to develop a new individual by introducing male reproductive material.

eugenics -> the study of how to arrange reproduction within a human population to increase the occurrence of heritable characteristics regarded as desirable. Developed largely by Sir Francis Galton as a method of improving the human race, eugenics was increasingly discredited as unscientific and racially biased during the 20th century, especially after the adoption of its doctrines by the Nazis in order to justify their treatment of Jews, disabled people, and other minority groups.

debunk -> expose the falseness or hollowness of (a myth, idea, or belief).

tally -> a current score or amount.

retaliation -> the action of returning a military attack; counterattack.

predicate -> the part of a sentence or clause containing a verb and stating something about the subject (e.g., went home in John went home ).

reconcile -> restore friendly relations between.

prosecution -> the institution and conducting of legal proceedings against someone in respect of a criminal charge.

prudence -> the quality of being prudent; cautiousness.

permutation -> a way, especially one of several possible variations, in which a set or number of things can be ordered or arranged.

doppelganger -> an apparition or double of a living person.

dye -> a natural or synthetic substance used to add a color to or change the color of something.

pathology -> the science of the causes and effects of diseases, especially the branch of medicine that deals with the laboratory examination of samples of body tissue for diagnostic or forensic purposes.

fellow -> a man or boy.

dialect -> a particular form of a language which is peculiar to a specific region or social group.

fella -> nonstandard spelling of fellow, used in representing speech in various dialects.

convo -> a conversation.

build -> the dimensions or proportions of a person's or animal's body. ( as a noun )

slenderly -> (of a person or part of the body) gracefully thin.

slim -> (of a person or their build) gracefully thin; slenderly built (used approvingly).

likeness -> the fact or quality of being alike; resemblance.

hark -> listen.

incompetent -> not having or showing the necessary skills to do something successfully.

ick -> sudden feeling of disgust or loss of attraction toward someone you used to like — often for a small or even silly reason.

deception -> the action of deceiving someone.

oblivion -> the state of being unaware or unconscious of what is happening.

resurrection -> being brought back to life after dying.

crucify -> put (someone) to death by nailing or binding them to a cross, especially as an ancient punishment.

brunette -> a person with dark brown hair (typically used of a woman).

incarnation -> the physical or human form of something abstract, spiritual, or divine.

obscuration -> the action of hiding or concealing something.

haze -> a slight obscuration of the lower atmosphere, typically caused by fine suspended particles.

ascertain -> find (something) out for certain; make sure of.

riddle -> a question or statement intentionally phrased so as to require ingenuity in ascertaining its answer or meaning, typically presented as a game.

incarceration -> the state of being confined in prison; imprisonment.

sabotage -> deliberately destroy, damage, or obstruct (something), especially for political or military advantage.

prosecute -> institute legal proceedings against (a person or organization).

affluent -> (especially of a group or area) having a great deal of money; wealthy.

adhesive -> able to stick fast to a surface or object; sticky.

brothel -> a house where men can visit prostitutes.

chronic -> (of an illness) persisting for a long time or constantly recurring.

psoriasis -> a chronic (long-term) skin disease.

alopecia -> the partial or complete absence of hair from areas of the body where it normally grows; baldness.

sentience -> feel, perceive, or experience things.

preface -> an introduction to a book, typically stating its subject, scope, or aims.

hatred -> intense dislike or ill will.

abomination -> a thing that causes disgust or hatred.

red herring -> something that distracts you from the main issue or misleads you.

kinky -> involving or given to unusual sexual behavior.

virtuous -> having or showing high moral standards.

infant -> a very young child or baby.

refutable -> able to be proven wrong or denied.

proliferation -> rapid increase in numbers.

wane -> (of the moon) have a progressively smaller part of its visible surface illuminated, so that it appears to decrease in size.

fertile -> (of soil or land) producing or capable of producing abundant vegetation or crops.

novel -> new or unusual in an interesting way.

facet -> one side of something many-sided, especially of a cut gem.

immense -> extremely large or great, especially in scale or degree.

manifold -> many and various.

degrade -> treat or regard (someone) with contempt or disrespect.

intrinsic -> belonging naturally; essential.

chemo -> chemotherapy.

tame -> (of an animal) not dangerous or frightened of people; domesticated.

domesticated -> (of an animal) tame and kept as a pet or on a farm.

clam -> https://upload.wikimedia.org/wikipedia/commons/a/ad/Clams_on_Sandy_Hook_beaches_-_panoramio.jpg

genital -> relating to the human or animal reproductive organs.

giggle -> laugh lightly in a nervous, affected, or silly manner.

stir -> move a spoon or other implement around in (a liquid or other substance) in order to mix it thoroughly.

conversely -> introducing a statement or idea which reverses one that has just been made or referred to.

clout -> influence, power, or fame, especially on social media.

stint -> supply an ungenerous or inadequate amount of (something).

marine -> of, found in, or produced by the sea.

paunch -> big, soft, or protruding belly, especially in men.

accentuate -> make more noticeable or prominent.

burp -> noisily release air from the stomach through the mouth.

bloke -> similar to how Americans might say guy, dude, or fella.

redeem -> compensate for the faults or bad aspects of (something).

remedy -> a medicine or treatment for a disease or injury.
